FTX Trading Bot | FREE Crypto Trading Robot | Crypto Trading Bot | FTX Trading Tutotial	True
Fantom Arbitrage Tutorial - Secret Money Making Method With Flash Loan Arbitrage And CREAM	True
Flash Loan Arbitrage - 500x BNB Leverage Trading Bot - INSTANT PROFIT HERE - Code in Description!	True
Flash Loan Arbitrage Bot and Multiplier BNB 3x-50x BNB Flash Loan Arbitrage Trick/ No RISK!	True
Flash Loan Arbitrage Bot and Multiplier BNB 3x-50x BNB Flash Loan Attack Tutorial / No RISK! 2022	True
Flash Loan Arbitrage Bot and Multiplier BNB 3x-50x BNB Flash Loan Attack Tutorial / No RISK! 2022	True
Flash Loan Arbitrage Bot and Multiplier BNB 3x-50x BNB Flash Loan Attack Tutorial / No RISK! 2022	True
Flash Loan Arbitrage Bot and Multiplier BNB 3x-50x BNB Flash Loan Attack Tutorial / No RISK!	True
Flash Loan Arbitrage Bot and Multiplier BNB 3x-50x BNB Flash Loan Attack Tutorial / No RISK!	True
Flash Loan Arbitrage Bot and Multiplier BNB 3x-50x BNB Flash Loan Attack Tutorial / No RISK!.	True
Flash Loan Arbitrage Bot and Multiplier BNB 3x-50x BNB Flash Loan Attack Tutorial / No RISK!.	True
Flash Loan Arbitrage Bot is NEW! Create Free Ethereum [STEP BY STEP] Without Coding	True
Flash Loan Arbitrage On Metamask Fantom Works Perfectly: How To Make 680+ FTM Easy	True
Flash Loan Arbitrage Trading Bot | Step by Step Tutorial - 10x Leverage Trading with BNB	True
Flash Loan Arbitrage Using BNB Using Uniswap Bot Code | 2022 Update	True
Flash Loan BNB this Code can Make Millions! | Uniswap & Sushiswap Flashloan Arbitrage Tutorial	True
Flash Loan BNB this Code can Make Millions! | Uniswap & Sushiswap Flashloan Arbitrage Tutorial	True
Flash Loan BNB this Code can Make Millions! | Uniswap & Sushiswap Flashloan Arbitrage Tutorial	True
Flash Loan BNB this Code can Make Millions! | Uniswap & Sushiswap Flashloan Arbitrage Tutorial	True
Flash loans Arbitrage Trading Bot | Step by Step Tutorial - 10x Leverage Trading with MATIC!	True
Flashloan Arbitrage Bot and multiply BNB 10-20x | Make 1-5 BNB an Hour	True
Flashloan Arbitrage Bot and multiply FTM 10-20x | Make 1-5 FTM an Hour	True
Free Avalanche AVAX using Zero Code Flash Loan Make 100+ AVAX A Day !	True
Free Avalanche AVAX using Zero Code Flash loans. Make 100+ AVAX A Day !	True
Free Avalanche AVAX using Zero Code Flash loans. Make 100+ AVAX A Day.	True
Free Binance Trading Bot 2022 Crypto Trading Bot Free Download BOT OKX FTK	True
Free Binance Trading Bot 2022 | Crypto Trading Bot Free Download BOT	True
Free Binance Trading Bot 2022 | Crypto Trading Bot Free Download	True
Free Binance Trading Bot 2022 | Crypto Trading Bot Free Download	True
Free Binance Trading Bot 2022 | Crypto Trading Bot Free Download	True
Free Crypto | Make $1000 a day | UniSwap/PancakeSwap Flash Loan Arbitrage | AVAX | Updated 2023	True
Free Crypto | Make $1000 a day | UniSwap/PancakeSwap Flash Loan Arbitrage | BNB | Updated	True
Free Crypto | Make $1000 a day | UniSwap/PancakeSwap Flash Loan Arbitrage | ETH	True
Free FREE METAMASK TRADING BOT | PANCAKESWAP TRADING BOT | INSANE PROFITS 12.05.2023	True
Free Metamask Trading Bot 2023 | Pancakeswap Trading Bot 2023	True
Front Run Crypto Smart Contract Sniper Bot | 100x Return | EASY TUTORIAL | NO DOWNLOAD | Phanta Bear	True
Front Running Bot 2023 ! Pancake swap snipe bot - link in the First Comment	True
Front Running Bot Uniswap V2 - Tutorial (Passive Income)	True
Full Tutorial  AVALANCHE (AVAX) Flash Loan Arbitrage Bot	True
G#Huge Profits ! BNB Flash Loan Arbitrage Uniswap ...	True
GRAB 200-BNB Free on Uncollateralized Flash Loan Arbitrage Attack - TRY! Our New Smart Contract Code	True
Generate +60% a DAY using an Ethereum MEV Bot [Easy Tutorial Step By Step] (UPDATED)	True
Get $3200 in Minutes from ETHEREUM Flash Loan Arbitrage Trick  - Working Tutorial 2023	True
Get 5-30 BNB Free With Flash loan Arbitrage Tutorial |	True
Get 5-30 BNB Free With Flash loan Arbitrage Tutorial |.	True
Get 5-30 BNB Free With Flash loans Arbitrage Tutorial | 2022	True
Get UNLIMITED Avalanche AVAX using this method! | AVAX FLASH LOAN EXPLOIT 2022	True
Get UNLIMITED Avalanche AVAX using this method! | AVAX FLASH LOAN EXPLOIT 2022	True
Get UNLIMITED Avalanche AVAX using this method! | AVAX FLASH LOAN EXPLOIT 2022	True
Get UNLIMITED BNB DAILY FREE Using BNB Flash Loan Arbitrage Bot Full Tutorial Method	True
Get UNLIMITED BNB using this method! | BNB FLASH LOAN EXPLOIT | Uniswap	True
Get UNLIMITED BSC BNB using this method! | BNB Flash loan EXPLOIT!	True
Get free BNB using No Code | BINANCE Flash Loan Arbitrage Tutorial Make 1000$ a day!!!	True
Get your 1-10 BNB on Flash Loan Arbitrage with Pancakeswap Smart Contract Flashloan 2023	True
Ghost Sniper - :crown:Pancake Swap Bot Sniper:crown: [Cracked]	True
Ghost Sniper :fleur-de-lis:BEST PANCAKE SWAP TRADING BOT:fleur-de-lis: [Cracked]	True
HERE'S THE STEP BY STEP GUIDE ON HOW TO APLLY ARBITRAGE BOT USING FLASHLOAN ON BSC…	True
HUGE PROFITS - BNB Flash Loan Arbitrage Uniswap & PancakeSwap - Easy Tutorial - Beginner friendly	True
HUOBI BOT TRADING 2022	True
Hack Binance Flash Loan upto $10000 For FREE | Flashloan Loan Arbitrage	True
High frequency trading bot ( Arbitrage crypto trading bot)	True
Highly Working Flashloan Arbitrage | How to double BNB in 1 hour | BNB with DeFi Tutorial	True
How I Earn 10.7 BNB Easily Using Flash Loan Arbitrage | Easy Profits in Minutes!	True
How I LEGALLY Made $175k Passive Income Daily Farming On Uniswap Arbitrage bot MEV December 2022	True
How I LEGALLY Made $200k Passive Income Daily Farming On Uniswap (Arbitrage bot+MEV) December 2022	True
How I LEGALLY Made $200k Passive Income Daily Farming On Uniswap (Arbitrage bot+MEV) Sept 2022	True
How I LEGALLY Made $200k Passive Income Daily Farming On Uniswap Arbitrage bot+MEV December 2022	True
How I LEGALLY Made Over 1 ETH Passive Income Daily Farming On Uniswap using a MEV Bot	True
How I Made $50k Passive in 3 Month Farming On Uniswap (Arbitrage bot + MEV) December 2022	True
How I Make +1200 /DAY Passive Income With Uniswap/Solidity - Easy Tutorial	True
How I Make 100+ AVAX in 3 Minute Flash loan Explained EARN FREE AVAX Avalanche	True
How I Make 100+ AVAX in 3 Minute Flash loans Explained EARN FREE AVAX Avalanche !	True
How I Make 15 FTM  in 5 Minute Using Flash Loan and Pangolin FANTOM	True
How I Make 4 ETH in 1 Minute - Uniswap ETH Flash Loan Arbitrage Trick [ACTUALLY WORKING] 2022	True
How I Make 4 ETH in 1 Minute - Uniswap ETH Flash Loan Attack Explain [ACTUALLY WORKING]	True
How I Make 4 ETH in 1 Minute ETH Flash Loan Attack Explain ARBITRAGE 2022	True
How I Make 4 ETHER in 1 Minute - Uniswap Crypto ETH Flash Loan Attack Explain [ACTUALLY WORKING]	True
How I Make 4 ETHEREUM Flash Loan Arbitrage Trick in 1 Minute Free ETHEREUM Easily 2022	True
How I made $340 using this crypto bot doing Arbitrage | pionex crypto currency bot|	True
How I make $5000 daily with a bot on Pancakeswap (Updated May 2022)	True
How To Do Simple Flash Loan Attack On Pancakeswap Earn ETH With A Smart Contract Uniswap.	True
How To Do Simple Flash loan Attack On Pancakeswap Earn AVAX With A Smart Contract Avalanche 2022	True
How To Do Simple Flash loan Attack On Pancakeswap Earn AVAX With A Smart Contract Avalanche!	True
How To Do Simple Flash loan Attack On Pancakeswap Earn AVAX With A Smart Contract Avalanche	True
How To Do Simple Flash loan Attack On Pancakeswap Earn BNB With A Smart Contract BSC 2022	True
How To Do Simple Flash loans Attack On Pancakeswap Earn AVAX With A Smart Contract Avalanche !	True
How To Do Simple Flash loans Attack On Pancakeswap Earn AVAX With A Smart Contract Avalanche.	True
How To Earn $300-$600+ Ethereum Daily (Chainide Method)	True
How To Earn 100+ AVAX Easily Using Flash loan Arbitrage On Metamask Avalanche Works Perfectly 2022	True
How To Earn 100+ AVAX Easily Using Flash loan Arbitrage On Metamask Avalanche Works Perfectly.	True
How To Earn 100+ AVAX Easily Using Flash loans Arbitrage On Metamask Avalanche Works Perfectly .	True
How To Earn 100+ AVAX Easily Using Flash loans Arbitrage On Metamask Avalanche Works Perfectly.	True
How To Earn AVAX Easily Using Flash loan Arbitrage On Metamask Avalanche Works Perfectly 2022	True
How To Earn AVAX Easily Using Flash loan Arbitrage On Metamask Works Perfectly.	True
How To Earn AVAX Easily Using Flash loans Arbitrage On Metamask Avalanche Works Perfectly	True
How To Earn AVAX Easily Using Flash loans Arbitrage On Metamask Works Perfectly	True
How To Earn AVAX Easily Using Flash loans Arbitrage On Metamask Works Perfectly.	True
How To Earn AVAX Flash Loan Attack Trick On Metamask Works Perfectly.	True
How To Earn BNB Easily Using Flash loan Arbitrage On Metamask Works Perfectly !	True
How To Earn BNB Easily Using Flash loan Arbitrage On Metamask Works Perfectly !	True
How To Earn BNB Easily Using Flash loan Arbitrage On Metamask Works Perfectly !	True
How To Earn BNB Easily Using Flash loan Arbitrage On Metamask Works Perfectly 2022	True
How To Earn FTM FANTOM Easily Using Flash Loan Arbitrage On Metamask Works Perfectly	True
How To Flash loan Attack On Pancakeswap Earn Free AVAX With A Smart Contract Avalanche!	True
How To Flash loan Attack On Pancakeswap Earn Free BNB With A Smart Contract Full Tutorial BSC	True
How To Flash loan Attack On Pancakeswap Earn Free BNB With A Smart Contract Full Tutorial BSC.	True
How To Flash loans Attack On Pancakeswap Earn Free AVAX With A Smart Contract Avalanche !	True
How To Flash loans Attack On Pancakeswap Earn Free AVAX With A Smart Contract Avalanche!	True
How To Flash loans Attack On Pancakeswap Earn Free BNB With A Smart Contract Full Tutorial BSC 2022	True
How To Make $1000+ Passive Income On Uniswap | Crypto Arbitrage Trading Bot Tutorial	True
How To Make Big Profit Using Bot Pancakeswap | Cryptocurrency Tips And Tricks	True
How To Make ETH With Uniswap in 2023 - No Code Flash Loan (For Beginners)	True
How To Make Money With Uniswap For Beginners (2022)	True
How To Setup An Unlimited Flash loan Crypto Arbitrage Bot	True
How To Start Earning $700/Day In Crypto Passive Income (Beginner Tutorial)	True
How to Liquidity Pool on Sushiswap with MASQ	False
How to MAKE and SELL your OWN crypto coin (Create token in LESS than 15 minutes)	False
How to Make $1000+/DAY With an MEV Ethereum Uniswap Bot - ETH Sniper Bot Tutorial	True
How to Make $1500/DAY Passive Income on Uniswap! EASY 2022	True
How to Make 20X BNB With Flash Loan Arbitrage Contract | 2023 Tutorial	True
How to Make 20X BNB With Flash oan Arbitrage Contract / 2023 Tutorial	True
How to Make 30%+/DAY With a Sandwich MEV Trading Bot - Curve Finance Tutorial	False
How to Make 40%+/DAY With an MEV Ethereum Bot - Easy Tutorial [No Download]	True
How to Make Money in Crypto WITHOUT Trading!!	False
How to Make Money with this Crypto Arbitrage Trading Strategy	False
How to Perform a Flash-Loan attack on PancakeSwap | Earn 100x BNB Crypto Without Coding | TUTORIAL	True
How to Play Kalista & SOLO CARRY for BEGINNERS + Best Build/Runes Season 13 - League of Legends	False
How to Play Lissandra & CARRY for Beginners + Best Build/Runes | Lissandra Guide Season 13 LoL	False
How to Play PancakeSwap Prediction to WIN money	False
How to Play Pancakeswap Lottery and win the Lottery | Get your tickets now! Pancakeswap BSC	False
How to Purchase DBME on PancakeSwap	False
How to STAKE OR UNSTAKE the ILV Crypto token?	False
How to Secure Your Metamask Wallet Using a Trezor Hardware Device	False
How to Sell Doge in Trust Wallet	False
How to Sell a Coin in Pancakeswap Using Trust Wallet || Step by Step In Telugu || Mumbai pilla	False
How to Set Price Alerts for all Coins on Pancakeswap and Get Notifications on Your Mobile Phone?	False
How to Set Token Price Pancakeswap in 3 Minutes / Pancakeswap Liquidity Start | Diogenes Casares	False
How to Stake Babycake & BNB to earn more Cake in pancake swap Farm Auction BABYCAKE How to earn more cake coins $cake	False
How to Stake OHM on Avalanche Network (NO MORE ETH FEES)!!!	False
How to Swap ETH for BNB without PancakeSwap!	False
How to Swap METAWAR Airdrop Real. How to Sell or Withdraw Metawar token. Swap MetaWar to ETH or BNB	False
How to Swap USDT to BNB in Trust Wallet	False
How to Swap in Trust Wallet via Pancakeswap / How to use Pancakeswap via Trust Wallet	False
How to Trade Fast Pumping Coins on #TRUSTWALLET via #Pancakeswap...	False
How to Use Biswap - BEST DEX on BNB Chain! Full Guide	False
How to Use Pancake Swap & Connect to Binance Smart Chain with MetaMask	False
How to Use Uniswap on Trust Wallet	False
How to Use Uniswap! How to Add A Custom Token	True
How to Use the DinoSwap DEX On Polygon Network to Stake & Farm on the Polygon Network	False
How to Use the New Brave Wallet	False
How to Withdraw METAMUSK Airdrop. Swap METAMUSK to ETH or BNB using Trustwallet or any wallet	False
How to Withdraw or Sell MetaWar Token. How to Swap METAWAR Airdrop. Trustwallet/Metamask Token Sell	False
How to Wrap PKT and buy/sell it on PancakeSwap (WPKT)	False
How to add Flashbots Protect RPC to your Metamask and trade on SushiSwap	False
How to add a Logo for your token	False
How to add token contract to uniswap	False
How to analyze MEV transactions on Dune Analytics (Uniswap v2)	False
How to build a Acala Arbitrage Bot using on-chain Oracle & Scheduler	False
How to build a Decentralized Exchange like Uniswap	False
How to buy $SHI on PancakeSwap	False
How to buy 4TOKEN on PancakeSwap and How to Bridge 4TOKEN	False
How to buy Baby Doge Coin on iPhone using Pancake :pancakes: Swap & Trust Wallet :handbag:	False
How to buy Baby Dogecoin on PancakeSwap | Baby Doge Coin	False
How to buy GMT: PancakeSwap instruction	False
How to buy adstakers utility token through pancakeswap on trustwallet make 6x by staking	False
How to buy fintoch FTC from pancake swap steps by Damain	False
How to buy or sell ERC-20 tokens on Uniswap. Terareum Example. Slippage Discussion. Tutorial	False
How to buy token on PancakeSwap?	False
How to cash out a PancakeSwap without paying a tax?	False
How to check any New Coin Price PanCakeswap	False
How to claim impt token and swap on uniswap | impt listing update	False
How to connect Pancakeswap to metamask for Android(Tagalog)	False
How to deploy Smart Contract to Polygon/Matic Chain or any Ethereum based chain	False
How to deploy a Flashloan Arbitrage Bot to multiply AVAX 10-20x new contract Working November 2022	True
How to deploy a Flashloan Arbitrage Bot to multiply MATIC 20x new contract Working | January Update	True
How to deploy a Frontrunner or sandwich attack on pancakeswap to make tons BNB of beginners level	True
How to earn 1000$/Day in 1inch Swap?	True
How to earn passive crypto income with Bitcoin??? #cryptonews #bitcoinnews #passiveincome	False
How to earn passive crypto income with Ethereum?	False
How to execute PancakeSwap Flash Loan & make profit and get free ...Pls. watch the Video.	True
How to find the best Liquidity Pools on Uniswap & Mooniswap Using 1inch!	False
How to get your own automated crypto arbitrage trading bot	False
How to make $1000 DAY with a MEV BOT | Ethereum Uniswap | No Download |	True
How to make $1000 using a MEV Ethereum Uniswap Bot [Step by Step Tutorial] (2023 Updated)	True
How to make $1000+ a day passive income with Uniswap & Ethereum - Full Tutorial	True
How to make $1000/DAY after The Merge on 1inchswap? #ethereum	True
How to make $1000/DAY on UniSwap? #ethereum	True
How to make $1200 per Day using Uniswap DeFi Trading Bot	True
How to make $1200/Day on UniSwap - Beginners	True
How to make $1500/DAY on UniSwap - Passive Income	True
How to make $300 DAILY with this CRYPTO ARBITRAGE BOT	True
How to make +55%/DAY With a MEV Ethereum Bot - Easy Tutorial - [No Download]	True
How to make 1000$ day on Uniswap Trading Bot  #ethereum	True
How to make 25$ every 10 minute /BTC Crypto Arbitrage exchange / new strategy 2023	False
How to make 25$ every 10 minute /BTC Crypto Arbitrage exchange / new strategy 2023	False
How to make 25$ every 10 minute /BTC Crypto Arbitrage exchange / new strategy 2023	False
How to make 500$ daily with crypto arbitrage	True
How to make 60%/+day with a BNB MEV Bot - Easy tutorial - no download | BNB Frontrun Bot Tutorial	True
How to make BNB with Flash Loan Arbitrage on Pancakeswap Easy to Earn with  No Risk	True
How to make BNB with Flash Loan using PancakeSwap and SelfArbitrage in DeFi	True
How to make ETH with flashswap using Uniswap Bot Code and SelfArbitrage in DeFi	True
How to make Money with BNB FLASH LOAN ARBITRAGE ON BAKERYSWAP & Pancakeswap..	True
How to make Money with BNB FLASH LOAN ARBITRAGE ON BAKERYSWAP & Pancakeswap..	True
How to make Passive Income with cryptocurrency | Pancake Swap Staking	False
How to make a free triangular cryptocurrency arbitrage bot on ChatGPT	False
How to make a token 2022	False
How to make money on Dex? History of UniSwap!	False
How to make money online without refferals | Latest crypto earning application 2022	False
How to make money with Crypto Arbitrage	False
How to purchase SafeMoon using MetaMask and PancakeSwap	False
How to save gas fees on Ethereum token swaps use pancakeswap on binance smart chain #pancakeswap	False
How to save yourself from inflation? It's time for Uniswap v3 :fire::money bag::euro banknote: Useful sites #bitcoin #crypto #uniswap #defi	False
How to sell axt or any token on pancakeswap	False
How to send BNB from Binance to Metamask & Pancakeswap	False
How to set up MetaMask Wallet - MetaMask Tutorial to create your MetaMask Wallet	False
How to solve PancakeSwap ERROR and use lower SLIPPAGE TOLERANCE when swapping token?	False
How to stake BNX   Earn INSANE REWARDS :collision: Stake BinaryX	False
How to stake Cake token on Pancakeswap auto Syrup Pools using Trust Wallet | LP pool vs Syrup Pool	False
How to stake in PancakeSwap?	False
How to swap for NPXS in Uniswap	False
How to swap sos for eth	False
How to swap your ETH for rETH? Staking with Rocket Pool!	False
How to use PancakeSwap with Trust Wallet Tutorial | Pancakeswap trust wallet tutorial	False
How to use PancakeSwap | Step by Step Guide | Liquidity Providing & Custom Tokens | Tutorial 2022	False
How to withdraw and  swap freecoin (erc20) on trust wallet using uniswap | guild (English version)	False
Huge Crypto Arbitrage Trading on Binance $10 per day	False
Huge Profits ! BNB Flash Loan Arbitrage Tutorial Uniswap & Pancakeswap Flashloan !	True
Huge Profits ! BNB Flash Loan Arbitrage Uniswap & Pancakeswap Flashloan ! Beginner friendly Tutorial	True
Huge Profits ! ETH Flash Loan Arbitrage Uniswap & Pancakeswap Flashloan ! for Begginers !	True
Huge Profits! (600+ FTM +) FANTOM Flash Loan Arbitrage Trading Bot | 10X with FTM Flash Loan	True
Huge Profits! 900 BNB  BINANCE Flash Loan Arbitrage Trading Bot EASY   10X with BNB Flash Loan	True
Huge Profits! BNB Flash Loan Arbitrage Pancakeswap Flashloan ! COMPLETE GUIDE for BEGINNERS	True
Huge Profits! BNB Flash Loan Arbitrage Pancakeswap Flashloan ! COMPLETE GUIDE for BEGINNERS	True
Huge Profits! ETH Flash Loan Arbitrage Tutorial Uniswap & Pancakeswap Flashloan ! Beginner friendly	True
Huge profits on the new Front run bot - PancakeSwap - UniSwap - 2023	True
I Asked ChatGPT To Do A $5000 WordPress Job...	False
I Coded a Trading Bot for Binance Smart Chain :mage:  To Snipe Listings & Place Limit Orders on BSC	False
I FINALLY GOT A WIN IN WARZONE 2.0?	False
I Joined a Crypto Pump Group. This is How Much I Made $$$$	False
I Made 100 BNB following this steps using Flash Loan Arbitrage Crypto # Flashloan# Arbitrage#Binance	True
I Tested Best Crypto Arbitrage Methods  Unlimited Dollar Arbitrage Using Binance	True
I Tried Out This Crypto Arbitrage Bot! (~30% APR) | Pionex Trading Bot Review	True
I Tried Out This Crypto Arbitrage Bot! (~30% APR) | Pionex Trading Bot Review	False
I Tried PancakeSwap For A Week	False
I Tried The BEST Arena Player’s Controller Settings! (AIMBOT)	False
I bought SUSHI (SushiSwap) + NEW TWITTER GIVEAWAY!!!	False
I found a way to do Flashloans on Binance Smart Chain	True
I walked for earning GST on 10th of December at Stepn	False
INSUFFICIENT OUTPUT AMOUNT ERROR ON PANCAKESWAP (SOLVED)	False
IPCAPITAL: How you can buy the IPC token on Pancakeswap.	False
In Arbitrage there is a Chance to  earn Binance Crypto through FLASH LOANS	True
Instructions to buy THG on pancakeswap to send staKing on DEFI autogame to receive daily compound interest	False
Introducing Miso: Cryptotesters Live with the Sushiswap Team	False
Is CAKE Coin a good investiment? #cake #pancakeswap #shorts	False
Is HFT latency arbitrage still possible for MT4 and MT5?	False
Is Overwatch 2 actually doing better than expected?? (Your Overwatch Podcast)	False
Is Sushiswap better than Uniswap?	False
Is Uniswap V3 the BEST DEX now?! UNI to $100 per token??	False
It Will Be Historical Move Of SushiSwap (SUSHI)	False
JUMPTASK token | BEST CRYPTO PROJECT for investment | CLAIM 500$ in AIRDROP	False
JUMPTASK | How to withdraw and swap your earnings #JumpToken	False
Jarek Hirniak | Army of Spies Cardano Long Form #1	False
JasmyCoin (JASMY) Bear Market Accumulation. JASMY Chart Analysis And Price Prediction 2023	False
Jonny Blockchain - Crypto arbitrage bot review (Case Study)	False
Kraken Trading Bot in Python	False
L7 TRADE - Cloud cryptocurrency arbitrage bot for earning	True
LATEST ETH FLASH LOANS ARBITRAGE UNISWAP AND PANCAKESWAP.	True
LCX DeFi Terminal - Limit Orders at Uniswap	False
LEG (Perkz Jhin) vs DYN (Rekkles Diana) - Game 1 SKE LEC | Season 2023 Kickoff | Dynasty vs Legacy	False
LIVE CRYPTO TA | MARKET TALK $ICP $BTC $ETH $ADA	False
LIVE: BITCOIN CRASHING NOW - HOW LOW WILL WE GO?	False
LUNC COIN में Big Rally :collision: || LUNC COIN Super BULLISH :rocket: || :backhand index pointing right:128000 BTC Sell :hot face: || LUNA CLASSIC UPDATE	False
LUNC Challenge! Can it be done? SHIB On the move! Why? Is this the crypto bottom? USDC giveaway!	False
LUNC REFLAMMABLE ELON MUSK CRITICAL REMARKS #luna #lunc #crypto #elonmusk #ftx #sbf	False
Latest Flash Loan Arbitrage Tutorial on Binance Smart Chain # Flashloan# Arbitrage#Binance#BNB	True
Learn How To Make FREE ETHER With This Ethereum Flash Loan Arbitrage Bot [2023]	True
Learn how to Farm BNSD Tokens on BNS.Finance || Uniswap || Liquidity Providers || DeFi	False
Learn how to Make 1000/DAY on Uniswap with this Bot Passive Income Beginner lever.	True
Learn how to build an Arbitrage Bot that uses Flash Loans (Paid course)	False
Learn to make $1000/DAY with a MEV BOT (Ethereum Uniswap Front-Running bot) [Easy Tutorial] [2023]	True
Learn to make $1000/DAY with a MEV BOT (Ethereum Uniswap Front-Running bot) [Easy Tutorial] [2023]	True
Ledger Swap: Exchange Crypto within Ledger Live Manager	False
Let's 50x Multiplier Finance FANTOM using 2022 on FTM Flash Loan Arbitrage Trick	True
Let's 50x Multiplier on Crypto using 2022 FTM FANTOM Flash Loan Arbitrage Trick	True
Let's 60x your BNB BINANCE using  BNB  Flash Loan Arbitrage Trick #FLASHLOAN #EXPLOIT#CRYPTO#BNB	True
Let’s 50x your BINANCE using 2022 BNB Flash Loan Attack Tutorial !	True
Let’s 50x your BINANCE using 2022 BNB Flash Loan Attack Tutorial 2022	True
Let’s 50x your BINANCE using 2022 BNB Flash Loan Attack Tutorial!	True
Let’s 50x your BINANCE using 2022 BNB Flash Loan Attack Tutorial	True
Let’s 50x your BINANCE using 2022 BNB FlashLoans Attack Tutorial!	True
Liquidity pools on UniSwap V3 | 70% per annum without risk is real? | How to choose an income pool	False
Live CPI Discussion: Is The Crypto Market Dead Thanks to Sam & His FTX?	False
Live CRYPTO ARBITRAGE | NEW  ARBITRAGE BETWEEN EXCHANGES | LOW RISK AND INSTANT PROFIT.	False
Logan Paul Might be Cooperating with the FBI | Matthew Cox	False
Logan Ross: Ethereum 2.0 Staking | Benzinga Crypto	False
Long term platform :money-mouth face: 30%ROI :check mark button: make big profits - check how!300$	False
Looking for BNB Coin | Try BNB Flash Loan Arbitrage Trick to Generate 500 BNB	True
Lost coins on pancake swap after staking? 2022 FIX!	False
Lunar Dao AMA Session 15th February 2023	False
M3GAN absolutely SLAYS | New Horror Icon Explained	False
MAKE MILLIONS WITH THIS TRIANGULAR ARBITRAGE on Binance (or any exchange)	False
MAKE MILLIONS WITH THIS TRIANGULAR ARBITRAGE on Binance (or any exchange)	False
MAKE MILLIONS WITH THIS TRIANGULAR ARBITRAGE on Binance (or any exchange)	True
MASSIVE NEWS!!! DOGECOIN SHIBA INU HOLDERS! :face screaming in fear::face screaming in fear::face screaming in fear: #DOGECOIN #SHIBAINU #CRYPTO	False
MATIC Flash Loan Arbitrage Tutorial Bot and multiply MATIC 5-100x with this Brand New Contract	True
MATIC Flash Loan Attack Explain 2022 New Arbitrage Trick Make a Million $$$ - Its Working!	True
MESSY AZZ SUPPORTERS BEHIND/IN FRONT OF THE SCENE!  THE CHAT is A BUNCH OF :snake:!  NIGHT BOT TRIPPIN!	False
MEV Bot Tutorial Create By ChatGPT | Ethereum Arbitrage Trading Bot | Jaredfromsubway.eth	True
MINDCAPITAL REVIEW NEW ARBITRAGE BOT PLATFORM - CRYPTO-FIAT	False
MKR COIN PRICE PREDICTION ! MKR COIN ENTRY & EXIT UPDATES ! MKR COIN LATEST CHART ANALYSIS !	False
MNW Crypto Price Has A Secret Whales Don't Want Out!	False
MULTIPLY YOUR BNB's with FLASH LOAN ON THE BSC NETWORK!!! UPDATED 10/2022!	True
Make $1000 A DAY on UniSwap trading with this Bot   Passive Income Beginner guide	True
Make $1000 A DAY on UniSwap with this Bot - Passive Income (Beginner) #ethereum	True
Make $1000 A DAY on UniSwap with this Bot - Passive Income (Beginner)	True
Make $1000 A DAY on Uniswap with this Bot - Passive Income (Beginner)	True
Make $1000 a DAY with a MEV Uniswap Ethereum Bot | Easy to follow Tutorial | 2023	True
Make $1000 a Day in AVAX Flash Loan Arbitrage Tutorial UniSwap/PancakeSwap with AVAX Method	True
Make $1000 a Day in ETH Flash Loan Arbitrage Trick l UniSwap/PancakeSwap with ETH Method / Risk Free	True
Make $1000 a Day in ETH Flash Loan Arbitrage Tutorial UniSwap/PancakeSwap with ETH Method /Risk Free	True
Make $1000 a Day in ETH Flash Loan Arbitrage Tutorial UniSwap/PancakeSwap with ETH Method/ Risk Free	True
Make $1000 a Day in ETHEREUM Flash Loan Arbitrage Tutorial UniSwap/PancakeSwap with ETH Method	True
Make $1000 a day with JaredFromSubway.eth Strategy  - PASSIVE INCOME-  Easy Tutorial (May 2023)	True
Make $1000 per Day using PancakeSwap? BNB Liquidity Front Running Bot	True
Make $10k/52 Week Passive income on PancakeSwap | TRADE & EARN	False
Make $1500 a DAY | Free 100 BNB Crypto | Pancakeswap/PancakeBunny Flash Loan Arbitrage Trick	True
Make $1K / Day | $1000 Daily profits with Mevengine Sandwich Frontrunning bot | Arbitrum | ETH | BSC	True
Make $2000 per Day with Uniswap Liquidity Front Running Bot #ethereum - NEW !	True
Make $700 DAY Triangular Arbitrage Bot that has a built-in stop loss function results after 12h	True
Make $800 A DAY on UniSwap with this Bot - Passive Income (Beginner) #Ethereum	True
Make +$700 per DAY Passive Income using Solidity & Uniswap Bot - Easy Tutorial	True
Make +60% per DAY using a MEV Ethereum Trading Bot Easy Tutorial 2023	True
Make 500% - 1000% Profits Daily Using This FREE STRATEGY On PANCAKESWAP (:hundred points: Verified)	True
Make Money With SHIB In The Bear Market! ($100/Day)	False
Make Over 600K Doing Shopping Arbitrage Online | Aliexpress	False
Make you millioner launching at pancakeswap 17 August 16 utc	False
Making Huge Profit On AVAX Using Flash loan Arbitrage On Metamask Avalanche!	True
Making Huge Profit On AVAX Using Flash loan Arbitrage On Metamask Avalanche!	True
Making Huge Profit On AVAX Using Flash loans Arbitrage On Metamask Avalanche !	True
Making Huge Profit On BNB Using Flash loan Arbitrage On Metamask BSC !	True
Making Huge Profit On BNB Using Flash loan Arbitrage On Metamask BSC !	True
Making Huge Profit On BNB Using Flash loan Arbitrage On Metamask BSC !	True
Making Huge Profit On BNB Using Flash loan Arbitrage On Metamask BSC 2022	True
Making Huge Profit On BNB Using Flash loan Arbitrage On Metamask BSC	True
Making Huge Profit On BNB Using Flash loan Arbitrage On Metamask BSC	True
Making Huge Profit On BNB Using Flash loan Arbitrage On Metamask BSC.	True
Making Huge Profit On BNB Using Flash loans Arbitrage On Metamask BSC !	True
Making Huge Profit On BNB Using Flash loans Arbitrage On Metamask BSC .	True
Making Huge Profit On BNB Using Flash loans Arbitrage On Metamask BSC	True
Mars Protocol - Crypto Bank in Cosmos ?	False
Massive Free BNB in Pancakeswap Flashloan Attack | Flash Loan Arbitrage | NEW Guide 2023	True
Massive Free BNB in Pancakeswap on BNB Flash Loan Arbitrage Tutorial |Guide 2022	True
Maximizing Your Profits: Flash Loan Arbitrage Bot with Ethereum and Uniswap Bot Update April 2023	True
Mempool Bot - Sniper - Snipe same block as liquidity ! Multi-chain sniper	True
Mempool Pancakeswap Sniper Bot - 12 Exchanges Supported - Honeypot & Rug Checkers! $1500 Lifetime	True
Mempool Snipe Bot (Uniswap)	False
Mempool Sniper Bot | +300$ Per Hour | Snipe same block as liquidity Multi-chain | 6jj4	True
Metamask Bot / Pancakeswap Bot / i have a clearly shown how i make two bnb in four hours	True
Metamask Bot / Pancakeswap Bot / i have a clearly shown how i make two bnb in four hours	True
Metamask Bot | Pancakeswap Bot | I have clearly shown how I make 4 bnb in 3 hours	True
Metamask Trading Bot / +20% Profit per Day / PancakeSwap Trading Bot / Pancakeswap Bot / Free	True
Metamask Trading Bot / +20% Profit per Day / PancakeSwap Trading Bot / Pancakeswap Bot / Free	True
Metamask Trading Bot / +20% Profit per Day / PancakeSwap Trading Bot / Pancakeswap Bot / Free	True
Metamask Trading Bot / +20% Profit per Day / PancakeSwap Trading Bot / Pancakeswap Bot / Free	True
Metamask Trading Bot / +20% Profit per Day / PancakeSwap Trading Bot / Pancakeswap Bot / Free	True
Metamask Trading Bot / +20% Profit per Day / PancakeSwap Trading Bot / Pancakeswap Bot / Free	True
Metamask Trading Bot / +5% 10% Profit per Day / PancakeSwap Trading Bot	True
Metamask Trading Bot / +5% 10% Profit per Day / PancakeSwap Trading Bot	True
Metamask Tutorial For COMPLETE Beginners	False
Metamask plugin for Wordpress - How to restrict page with NFT	False
Metamask trading Bot +342$ per day | Metamask Bot | Free download 2022	True
Metamask trading Bot +342$ per day | Metamask Bot | Free download 2022	True
Metamask trading Bot +342$ per day | Metamask Bot | Free download 2022	True
Metamask trading Bot +342$ per day | Metamask Bot | Free download 2022	True
Metamask trading Bot +342$ per day | Metamask Bot | Free download 2022	False
Metamask trading Bot +342$ per day | Metamask Bot | Free download 2022	True
Metamask trading Bot +342$ per day | Metamask Bot | Free download 2022	True
Metamask transaction Approving issue | Pancakeswap approval stuck | Pancakeswap transaction Stuck	False
Mine $3 BNB to $289 BNB :money bag: in Trust Wallet | FREE BNB	False
Mist NFT - Marketplace 3D znamy datę otwarcia | Kolejna gra PlayToEarn | AirDrop SushiSwap :eyes:	False
MistX - the world's FIRST flashbot powered DEX	False
Mojoeth token website review || token buy in uniswap || 800x soon ||	False
Monkey Drainer Full Source Code ETH DRAINER	False
More on Uniswap v3 Concentrated Liquidity Part 2	False
Most Important Video For All Airdrop Hunters :high voltage: DAO Voting Full Guide in Hindi	False
Move Your Dogecoin From Kraken to Trust Wallet | Stake in Pancakeswap and earn CAKE.	False
Multi sig wallet smart contract | Hindi	False
Multiply ETHER 1-20x with new Smart Contract | ETHEREUM Flash Loan Arbitrage Trick	True
Must Have Mods Released This Past Year for Farming Simulator 22	False
Must Haves… :money with wings::chart increasing::rocket: #Shorts	False
My Arbitrage Trading Strategies For Profit & Minimizing Risks - Crypto Hustle	False
My Binance arbitrage trading software is crashed - crypto arbitrage bot error	False
My Binance arbitrage trading software is crashed - crypto arbitrage bot error	False
My Ethereum Blockchain MEV Arb Bot Passive Income Solidity Tutorial October 2022	True
My Top 3 Passive Income Sources For 2023	False
My passive income numbers for November - How much did I make?	False
Mycelium Perpetual Swaps on Arbitrum || Decentralized Exchange Review	False
N10K Daily Dollar Arbitrage Secret Website	False
NEAR A HUGE PUMP IS COMING IN 2023 - NEAR PROTOCOL PRICE PREDICTION & ANALYSES	False
NEW  COIN  -Byepix (EPIX) - New Crypto Token - New Coin launching -new coin news	False
NEW  COIN  -DEXO (DEXO) - New Crypto Token - New Coin launching -new coin news	False
NEW  COIN  -Dejitaru Shirudo (SHIELD) - New Crypto Token - New Coin launching -new coin news	False
NEW  COIN  -Honor World Token (HWT) - New Crypto Token - New Coin launching -new coin news	False
NEW  COIN  -Morpho Network (MORPHO) - New Crypto Token - New Coin launching -new coin news	False
NEW  COIN  -One Hundred Million Inu (OHMI) - New Crypto Token - New Coin launching -new coin news	False
NEW  COIN  -Wrapped POM WPOM - New Crypto Token - New Coin launching -new coin news	False
NEW ARBITRAGE TRX | CRYPTO ARBITRAGE NEW INCOME SCHEME | BINANCE ARBITRAGE P2P | TRADING	False
NEW CARDANO DEX PLATFORM! (Will SundaeSwap Be The UniSwap of ADA?)	False
NEW CRYPTO AIRDROP CLAIM 500 PANCAKESWAP TOKEN INVEST PROJECT 2022	False
NEW CRYPTO AIRDROP CLAIM 500 PANCAKESWAP TOKEN INVEST PROJECT 2022:wrapped gift::wrapped gift::wrapped gift:	False
NEW CRYPTO ARBITRAGE STRATEGY 12% PROFIT | BEST P2P TRADING STARTEGY ON BINANCE	False
NEW CRYPTO TODAY :fire: CROSWAP :fire: NEXT PANCAKESWAP !? :fire: CRONOS CHAIN! :money bag: NEW ALTCOIN :fire:	False
NEW CRYPTO TODAY :rocket: SpaceDEX! :rocket: NEW TOKEN! :rocket: NEW CRYPTO DEX & MORE :rocket: NEW PANCAKESWAP LISTING TODAY!	False
NEW Crypto Arbitrage Strategy | Easy Profit 15% | Best P2P Cryptocurrency  Trading Scheme Binance	False
NEW FREE GUIDE on How To Make 89 BNB With UNISWAP FLASHLOAN Arbitrage	True
NEW IFO 3.0 CAKE POOL on Pancakeswap - How to stake Cake token Diviner Protocol DPT DEFI GAMEFI NFTs	False
NEW LIMITED PANCAKESWAP CRYPTO AIRDROP PROJECT | GET 500$ | NO DEPOSIT METHOD | 2023	False
NEW STRATEGY in UNISWAP V3 ​:fire:​ WHAT IS ARRAKIS FINANCE? :exploding head:​ + MY RESULTS! :bomb:	False
NEW SUPER TEAM! - The Nation vs BreakThru - HIGHLIGHTS | VALORANT Challengers NA 2023	False
NEW UNISWAP COMPETITOR??? MAVERICK PROTOCOL! EARLY POTENTIAL NEW DEFI EXCHANGE DEX ON ETHEREUM!	False
NEW YEAR’S EVE 2023 LIVE LAS VEGAS -Part 1	False
NEW! BNB (BINANCE) FLASH LOAN ARBITRAGE TRADING / TUTORIAL / EARN $2000/DAY PASSIVE...	True
NEW! Uniswap Contract Code For Flash Loan Arbitrage Using - Get 5 ETH in Minutes	True
NEW: Avalanche AVAX Flash Loan Arbitrage Tutorial - Easy Profit Method	True
NEW: BNB Flash Loan Arbitrage Tutorial - Easy Profit Method in a minute Hurry Apply Now	True
NFTX: Fractionalized NFT investing	False
NO ONE SAW THIS COMING! BANKS OPEN CRYPTO TRADING! NEXT BULL CYCLE WILL BREAK ALL THE RECORD HIGHS!	False
NUEVA ATRACCION #pancakeswap v3 #cake VALE LA PENA? :eyes:	False
NVIDIA Almost Got Away With This…AGAIN!	False
Navigation Bar Next Js | Build Uniswap Clone Dapp (Defi) Decentralized Exchange | Defi Exchange	False
New AVAX Flash Loan Attack Trick - Searching perfect Arbitrage.	True
New Arbitrage Strategy (Bitcoin 2022) |Binance VS FraxShare trade | 2022 CRYPTO ARBITRAGE TRADE	False
New Looking for BNB COIN | Try BNB Flash Loan Arbitrage Tutorial |GENERATE 500 BNB	True
New Risk Free Method in Deploying FTM Flash Loan Arbitrage Tutorial with Easy steps	True
New Smart Contract on BNB Flash Loan Attack Tutorial on PancakeSwap & Get Free 1-50 BNB !	True
New Smart Contract on BNB Flash Loan Attack Tutorial on PancakeSwap & Get Free 1-50 BNB 2022	True
New Smart Contract on BNB Flash Loan Attack Tutorial on PancakeSwap & Get Free 1-50 BNB 2022	True
New Smart Contract on BNB Flash Loan Attack Tutorial on PancakeSwap & Get Free 1-50 BNB	True
New Smart Contract on BNB Flash Loan Attack Tutorial on PancakeSwap & Get Free 1-50 BNB.	True
New Smart Contract on BNB FlashLoans Attack Tutorial on PancakeSwap & Get Free 1-50 BNB.	True
New Way of Phishing Attack :police car light:- Uniswap V3 Phishing Explained - English	False
New Working ETH Flash Loan Arbitrage Trick | How to double your ETHERIUM in 1 hour	True
New XRP arbitrage | Crypto arbitrage | Binance arbitrage | How to make first $ from arbitrage?	False
New airdrop PANCAKESWAP world project. Crypto drop 500$ coin free!	False
New mining app.Feminist mining application.Listed in pancakeswap.	False
Newest Defi Exploit Contract -Ultimate Binance Front Run Bot |# Flashloan #Arbitrage#Crypto#Binance	True
No Need to Think Twice on Binance Flash Loan Arbitrage Trick	True
No code tools #6 - BILDR | Build and ship apps faster with nocode tools	False
Noam Brown: AI vs Humans in Poker and Games of Strategic Negotiation | Lex Fridman Podcast #344	False
Now you know how to meet a girl:winking face with tongue::smiling face with sunglasses:#shorts	False
NumiSwap DEX SNIPER BOT // PROSNIPERBOT -  DEX TRADING BOT	True
OKX AUTOMATED ARBITRAGE TRADING BOTS	False
OPENSEA BOT | NFT GENERATOR + 500$ IN FIRST DAY | FREE DOWNLOAD | WORK 2022	True
OctoBot Arbitrage Troubleshooting	False
Official TWT airdrop. Claim your guaranted 500$ Trust wallet coin. Free airdrop!	False
Olympus Tutorial - How to get a Bond	False
Onsen AMA ft. Immutable X | Layer 2 For NFTs On Ethereum!	False
OpenSea Bot / 500$ PER DAY / NFT Bot / Opensea Tutorial / Opensea Bidding Bot/ Opensea Listing Bot	True
OpenSea Bot / NFT Bot 2022 / Fast Buy / Opensea Bidding Bot/ Listing Bot Opensea / 5000$ PER MONTH	True
Opening HEAVY Japanese Base Set Pokemon Booster Packs !!!	False
Orders placement | Cryptocurrency arbitrage bot - Part 10	False
P2A2 Arbitrage Trading Bot Business Plan....	False
P2P Crypto Arbitrage | Best Bitcoin P2P Strategy 2023 | 250$ For 15 Minutes	False
PANAROMA ECOSYSTEM EXPLAINED	False
PANCAKE ROUTER: INSUFFICIENT OUTPUT AMOUNT: How to fix Transaction ERROR on Pancake Swap.	False
PANCAKE SWAP V3 (Liquidity Providers Beware)	False
PANCAKE SWAP#MAE TACGOS BLOGS	False
PANCAKESWAP ( Take your MILLION ) | AIRDROP 500$ | CAKE	False
PANCAKESWAP (CAKE): Truth Revealed!! | Is CAKE The Next 16x Coin??? | CAKE Airdrop :alarm clock::alarm clock::alarm clock:	False
PANCAKESWAP BEST CRYPTO AIRDROP 2022 | TOKEN FREE CLAIM 500$	False
PANCAKESWAP BOT   BEST TRADING BOT	False
PANCAKESWAP BOT - SUPPORT 10 ADDRESSES AT THE SAME TIME / DEXTOOLS BOT	True
PANCAKESWAP BOT - SUPPORT 10 ADDRESSES AT THE SAME TIME / DEXTOOLS BOT	True
PANCAKESWAP BOT - SUPPORT 10 ADDRESSES AT THE SAME TIME / DEXTOOLS BOT	False
PANCAKESWAP BOT - SUPPORT 10 ADDRESSES AT THE SAME TIME / DEXTOOLS BOT	True
PANCAKESWAP BOT / FREE RUN BOT / MAKE X10 EVERY DAY / EASY PANCAKESWAP PRESALES	True
PANCAKESWAP BOT // PANCAKE SWAP TOKEN BOT //  POOL PANCAKESWAP BOT	True
PANCAKESWAP BOT // PANCAKE SWAP TOKEN BOT //  POOL PANCAKESWAP BOT	True
PANCAKESWAP BOT | +1250$ PER MONTH? THIS IS REAL! | BEST BOT FOR METAMASK	True
PANCAKESWAP BOT | +2300$ PER MONTH? THIS IS REAL! | BEST BOT FOR METAMASK | PANCAKESWAP TRADING BOT	True
PANCAKESWAP BOT | +2300$ PER MONTH? THIS IS REAL! | BEST BOT FOR METAMASK | PANCAKESWAP TRADING BOT	True
PANCAKESWAP BOT | +2300$ PER MONTH? THIS IS REAL! | BEST BOT FOR METAMASK | PANCAKESWAP TRADING BOT	True
PANCAKESWAP BOT | +2300$ PER MONTH? THIS IS REAL! | BEST BOT FOR METAMASK | PANCAKESWAP TRADING BOT	True
PANCAKESWAP CAKE - LOOK AT THIS AIRDROP!!! Biggest news	False
PANCAKESWAP CAKE PRICE CHART LOOKING GREAT !!!	False
PANCAKESWAP CRACK | PANCAKESWAP FREE DOWNLOAD | PANCAKESWAP CRACK 2023	True
PANCAKESWAP CRYPTO AIRDROP 2023 | FOR NEW USERS FREE CLAIM 500$ | FULL GUIDE 2023	False
PANCAKESWAP Coin Price Prediction | AIRDROP 5000$ | CAKE:loudspeaker::loudspeaker::loudspeaker::loudspeaker:	False
PANCAKESWAP Finance Token AirDrop | Claim $5000 | CAKE airdrop | Passive income in crypto!	False
PANCAKESWAP Financial ( INVEST Project ) | AIRDROP 500$ | coin	False
PANCAKESWAP Free Sniping Bot - DEXTOOLS BOT - UNISWAP BOT _ DESEMBER 2022	True
PANCAKESWAP Free Sniping Bot - DEXTOOLS BOT - UNISWAP BOT	True
PANCAKESWAP GET 500$ NOW | NO DEPOSIT METHOD | CRYPTO AIRDROP TRUSTPAD | 2023	False
PANCAKESWAP NASIL COİN ALINIR - SATILIR? PANCAKESWAP BORSASI NASIL KULLANILIR?	False
PANCAKESWAP New Private Crypto AirDrop Event | FREE GET 500$ Without Deposit | 2023 Only :smiling face with heart-eyes::smiling face with heart-eyes::smiling face with heart-eyes:	False
PANCAKESWAP PRICE PREDICTION 2021 - CAKE PRICE PREDICTION - SHOULD I BUY CAKE - PANCAKESWAP FORECAST	False
PANCAKESWAP Set For Another PUMP SOON? Claim Airdrop :green heart::green heart:	False
PANCAKESWAP TRADING BOT | PANCAKESWAP FREE DOWNLOAD | PANCAKESWAP CRACK 2022	True
PANCAKESWAP TRADING BOT | PANCAKESWAP FREE DOWNLOAD | PANCAKESWAP CRACK 2022	True
PANCAKESWAP crypto UPDATE | CAKE token price prediction | GET 500$ in AIRDROP	False
PANCAKESWAP crypto UPDATE | CAKE token price prediction | GET 500$ in AIRDROP	False
PANCAKESWAP token | BEST CRYPTO PROJECT for investment | CLAIM 500$ in AIRDROP	False
PANCAKESWAP | Airdrop 500$ | PANCAKESWAP news today token 2023 | Review CAKE	False
PASSIVE INCOME GROWING!!! EXP ASSET UPDATE AND ARBITRAGE BOT	False
PEPE AI ANSWERING DOUBTS REGARDING THE MILLIONAIRE PRE SALE OF THE CRYPTOCURRENCY TOKEN PEPE AI	False
PERFECT CRYPTO AIRDROP 500$ 2022 | CLAIM  CAKE TOKEN 500$	False
PHISHING WARNING please make sure you're visiting https://pancakeswap.finance -	False
PLR Smart AI | 4%-5% Daily / AI Trading Bot / Arbitrage / Passive Income	False
POLYGON (MATIC) Flash Loan Arbitrage Bot - Full Tutorial [Last Update: Sept onwards 2022]	True
POLYGON PRICE PREDICTION 2022:gem stone:IMPORTANT SIGNALS THAT ARE HINTING AT MATIC'S NEXT MOVE!:crown:TARGETS	False
POM Token Price Prediction | POM Token Listed on Shibnobi Swap	False
POOLS UNISWAP - EP.3 - Melhores ranges.	False
PREDIKISI HARGA BITCOIN! SILICON VALLEY BANK BANGKRUT? SVB KENAPA SIH? GIMANA KRONOLOGISNYA?	False
PREDIKISI HARGA BITCOIN! TARGET PRICE TERCAPAI! READY WAVE 3? BULLISH!	False
PRIVATE SCHEME OF CRYPTO ARBITRAGE ON BINANCE! | PROFIT 10% IN 10 MINUTES | BIG PROFIT WITHOUT RISK	True
PROFIT 8-11% PER TRADE | MY LITECOIN ARBITRAGE STRATEGY | CRYPTO ARBITRAGE | P2P BINANCE NEW	False
PROFIT IN 15 DAYS IN IFO ON PANCAKESWAP | FIRST PROFITABLE IFO ON THE APTOS NETWORK	False
PROJECT INTRO: Learn & Earn Crypto with Layer3! | Crypto Gossip	False
PROS staking is the PERFECT way to make PROFIT:rocket: How to stake PROS	False
PROSNIPERBOT - FOR THE PANCAKESWAP WEBSITE // PancakeSwap BOT	True
PROVIDER ERROR W/ MetaMask PANCAKESWAP iOS/Android	False
PVC Meta Listing PancakeSwap || Starting Price 15$ | SWAP KARNA SEEKHE ||@Pearlvinetechnicakguru	False
Pampanut markets tomorrow morning!	False
Pan cake with easy recipe #happycookingtoyou @Habiba Syed	False
PanCakeSwap { TOP } 500$ in AIRDROP | CAKE TOKEN RELEASE NEW	False
Pancake Swap Token Version 3 Price Prediction & Buy Sell Ladders	False
Pancake Swap Tutorial - How to Buy Exciting Binance Smart Chain Coins? | @MONEYTIZE	False
Pancake Token News Today|Pancake Token Update|Pancake Coin News|Pancake Buy Kaise Kare	False
Pancake swap tutorial for beginners | how to use pancake swap | Pancake swap cake coin |	False
PancakeSwap #Crypto Currency Buy||Target|| Pump And Dump||Alert short #Video #Subscribe COTO TIGER	False
PancakeSwap (Cake) a 500$ ?	False
PancakeSwap / Uniswap FRONT RUN BOT Crypto Bot MATIC Flash Loan Attack Explain	True
PancakeSwap / Uniswap FRONT RUN BOT Crypto Bot MATIC Flash Loan Attack Explain.	True
PancakeSwap :fire: Uniswap  Buying and Selling Bot :fire: Easy Trading with Script Profit +1000% :face screaming in fear:	False
PancakeSwap Arbitrage BNB Flash Loan Attack Tutorial can Earn 10 BNB free by using Contract Code	True
PancakeSwap Arbitrage BNB Flash Loan Attack Tutorial can Earn 10 BNB free.	True
PancakeSwap Arbitrage BNB Flash Loan Attack Tutorial can Earn 10 BNB free.	True
PancakeSwap BSC Token Bot PancakeSwap Bot BNB Token Bot	True
PancakeSwap Bot - Sniper Bot and many more features | New Update 	True
PancakeSwap Bot - Sniper Bot and many more features | New Update 	True
PancakeSwap Bot - Sniper Bot and many more features | New Update 	True
PancakeSwap Bot - Sniper Bot and many more features | New Update 	True
PancakeSwap Bot - The Best Front Running Bot 2022 (No Downloads) - Start making huge BNB profits	True
PancakeSwap Bot Sniper - Front Running PancakeSwap [UPDATED]	True
PancakeSwap Bot Sniper - Front Running on PancakeSwap [UPDATED]	True
PancakeSwap Crypto Token Bot // Universal Bot	True
PancakeSwap Crypto Token Bot // Universal Bot	True
PancakeSwap FRONT RUN BOT - Sniper Bot | Benefits x10 INSTANTLY - BEGINNER TUTORIAL (English)	True
PancakeSwap Front Run Bot  Easy 10x	True
PancakeSwap Front Run Bot (Sniper Bot) - Make x10 INSTANTLY (NO DOWNLOAD)	True
PancakeSwap Front Run Bot 2022 Latest Edition (Local downloading NOT required) BSC Auto Trader	True
PancakeSwap Front Run Contract Bot 2021 - EASY TUTORIAL (NO DOWNLOAD)	True
PancakeSwap Front Running  Contract BOT Easy Tutorial - (No Download)	True
PancakeSwap Front Running Bot 2023- NEW BNB Flash Loan Arbitrage Bot-10x Profits [Updated]	True
PancakeSwap Front Running Liquidity Sniper Bot Tutorial | Make 2 BNB or more per DAY	True
PancakeSwap Limited Crypto AirDrop | No Deposit Method How Claim 500$ | 2022 Only	False
PancakeSwap Lottery - When to Play & Odds of Winning!	False
PancakeSwap Migration - What should I do? Αnd a PancakeBunny tip!	False
PancakeSwap NEW SNIPER BOT / DOGESWAP / UNISWAP /  CAKE SWAP	True
PancakeSwap NEW SNIPER BOT / DOGESWAP / UNISWAP /  CAKE SWAP	False
PancakeSwap NEW SNIPER BOT / DOGESWAP / UNISWAP /  CAKE SWAP	True
PancakeSwap NEW SNIPER BOT / DOGESWAP / UNISWAP /  CAKE SWAP	False
PancakeSwap Prediction Bot   Pancakeswap Predictor Bot   90% Winrate	False
PancakeSwap Prediction Bot Full Tutorial 2022 | [MacOS & Windows]	False
PancakeSwap Prediction Bot Full Tutorial September 2022	False
PancakeSwap Prediction Loophole Demo	False
PancakeSwap Provider Error No Provider Was Found - how to fix it to connect your wallet and trade?	False
PancakeSwap Sniper Bot // mempool bot	True
PancakeSwap Staking: WORTH IT? | CAKE Coin Analysis	False
PancakeSwap Token Bot // MetaMask & Trust Wallet Bot	True
PancakeSwap Trading Bot   How to EARN 10 BNB EVERY DAY Sniper Bot   Front Running Bot	True
PancakeSwap Trading Bot - Metamask Swap Bot & PancakeSwap Sniper Bot / +400$ per day	True
PancakeSwap Trading Bot Sniper | MetaMask Trading Bot | + 1000$ per day	True
PancakeSwap Trading Tutorial for Beginners: How to buy and sell altcoins on the BNB network!	False
PancakeSwap Transaction Underpriced  SOLVED / Trust Wallet	False
PancakeSwap bot // NEW VERSION // PancakeSwap Sniper BOT	True
PancakeSwap bot // NEW VERSION // PancakeSwap Sniper BOT	True
PancakeSwap bot // NEW VERSION CRACK // PancakeSwap Sniper BOT	True
PancakeSwap on FTM Flash Loan Arbitrage Tutorial to Get 112 Fantom Instantly	True
PancakeSwap sidee loo isticmaalaa:::Beta group	False
PancakeSwap to Polygon Teaser | ARC Reactor	False
PancakeSwap: Poocoin Trading Swap bot	True
Pancakeswap #dex Sigue Dominando | Analisis Tecnico $CAKE	False
Pancakeswap (CAKE) The news today AIRDROP 5000$ PancakeSwap Token Review	False
Pancakeswap - Bakeryswap arbitrage Bot using Flash loan.	True
Pancakeswap - Cake crypto Coin ready for 7.7x Return | Pan Cake Swap Price Prediction Hindi	False
Pancakeswap Anleitung :check mark button:	False
Pancakeswap BEST CRYPTO AIRDROP 2023 * TOKEN FREE CLAIM 500$	False
Pancakeswap Bot +2864$ Per Week | Bot For Pancakeswap | Free Download	True
Pancakeswap Bot +600$ per week:crown: | Pancakeswap Bot:crown: | Free download	True
Pancakeswap Bot +600$ per week:crown: | Pancakeswap Bot:crown: | Free download	True
Pancakeswap Coin Price Prediction | Cake Coin News Today @TechyBiplab2.0	False
Pancakeswap Expert Mode Explained | How To Buy Tokens Quicker On Pancakeswap	False
Pancakeswap Flashloan Bot BNB Flash Loan Arbitrage Uniswap! Make 10 BNB Every Day 2023	True
Pancakeswap Future Trading | Pancakeswap Perpetual Trading Full Tutorial	False
Pancakeswap Liquidity | How to Check If LP is Locked and Token Listing Works	False
Pancakeswap Make millionaire || Cake Price Prediction! Cake Today Update	False
Pancakeswap MasterChef v2 Locked APY Vs Flexible APY Staking Hindi 2022	False
Pancakeswap Prediction Full Automatic Bot (We won 2 BNBs in just 2 rounds!)	True
Pancakeswap Price Prediction - Final Crash! - Altcoins Will Crash Again	False
Pancakeswap Sniper bot +10-200% per day | PANCAKESWAP TRADING BOT | PANCAKESWAP TUTORIAL	True
Pancakeswap Still massively Undervalued | All In On Cake - Why It Will Make Millionaires!	False
Pancakeswap Trading Bot   Best Pancakeswap Bot 2022   +80% per day   WORKING 06 03 2022	False
Pancakeswap Trading Bot / +70% profit every day / Pancakeswap Sniper bot / bsc sniper bot / python	True
Pancakeswap Trading Bot 2022 | Pancakeswap Snipe BOT | Metamask Trading Bot (Defi) | +101% per day	True
Pancakeswap Trading Bot 2022 | Pancakeswap Snipe BOT | Metamask Trading Bot (Defi) | +101% per day	True
Pancakeswap Trading Bot 2022 | Pancakeswap Snipe BOT | Metamask Trading Bot (Defi) | +101% per day	True
Pancakeswap Trading bot / +800$ per DAY / Best Metamask Trading Bot 2021!	True
Pancakeswap Trading bot / +800$ per DAY / Best Metamask Trading Bot 2021!	True
Pancakeswap Trading bot / +800$ per DAY / Best Metamask Trading Bot 2021!	True
Pancakeswap Trust Wallet Binance Smart Chain (BSC) BEP20 (Tutorial)	False
Pancakeswap bot / Metamask trading bot / Poocoin auto trading / Free bot + tutorial + bug site / EZ	True
Pancakeswap bot | pancakeswap sniper bot  | full tutorial | free download | :check mark button:WORKING 10/27/2022:check mark button:	True
Pancakeswap update - Limit Orders introduced	False
Pancakeswap-MasterChef Migration v2 (Hungarian language)	False
Pancakeswap: How-To  guide for fixed term stacking	False
Passive Income: Make $1050 DAY on UniSwap with this Bot (Beginner)	False
Pi Network Touch $10k Price | Wrapped Pi Token Launched on Pancakeswap | Pi Coin Latest Update	False
Pionex Arbitrage Bot | Crypto Arbitrage Trading | Arbitrage Bot Pionex	True
Pionex Arbitrage bot tutorial | pionex review step by step Guide|	False
Pionex Spot-Futures Arbitrage Bot...#shorts #crypto #arbitrage #arbitragetrading #pionex	False
Pionex TRADING BOT! (risk-free!)	True
Pionex Trading Bot | Crypto Trading Bot | Free download	True
PirateBSC - Make Money Online From Pancakeswap | Make Money Online	False
Pixel 7 PRO Review | Is It Actually the BEST Flagship?	False
Playing The Most ANNOYING Botlane Combo	False
Polkastarter can protect you from front running bots	False
Polygon Flash loan Arbitrage Trading Bot | 10x Leverage Trading with MATIC	True
Polygon Flash loan Arbitrage Trading Bot | 10x Leverage Trading with MATIC	True
Polygon Flash loan Arbitrage Trading Bot | 10x Leverage Trading with MATIC	True
Polygon Flash loans Arbitrage Trading Bot | 10x Leverage Trading with MATIC.	True
Polygon Sniper Bot // Qui	True
Polygon Sniper Bot // QuickSwap & UniSwap & PancakeSwap	True
Position Manager - cont. | Cryptocurrency arbitrage bot - Part 7	False
Powerful Arbitrage Trading Bot Makes $100 Daily.	False
Profits abound! AVAX Flash Loan Arbitrage Uniswap & Pancakeswap Flashloan	True
Profits with FANTOM Arbitrage on Deploying FTM Flash Loan Attack Tutorial with Flash Loan Script	True
Project 丨 Uniswap V3 is a wrong direction?	False
Protecting Your Portfolio in a Bear Market | The Bullpen | Gen & Robert	False
Puzzle Cats   Gameplay Walkthrough Level 99 iOS & Android #shorts #games #funny	False
Puzzle Cats | Sandwich Runner  Gameplay Walkthrough iOS & Android #shorts #games #funny 9-99 Levels	False
Quick ETH Flash Loan Arbitrage Tutorial / 0 Risk Auto Run Bot/ Smart Contract Code in Description	True
RBITRAGE NEW CRYPTO | Arbitrage Strategy New | Binance VS CREDITCOIN	False
RBN staking is the PERFECT way to make PROFIT:rocket: How to stake RBN	False
RECRUITING BAMS To FAZE..	False
RICHARD HEART PULSEX PULSECHAIN IMPORTANT UPDATE:check mark button:FOR INVESTORS BEFORE LAUNCH	False
RIOT Won't Ban Him..	False
ROBERT KIYOSAKI : SUSHI WIL X9000 AFTER THIS GREAT PARTNERSHIP - SUSHISWAP PRICE PREDICTION 2023	False
ROOTER App Offer Task Complete Kaise Kare | Rooter Offer Task Coins Added Problem Solve	False
RUNE COIN LATEST CHART ANALYSIS ! RUNE COIN PRICE PREDICTION ! RUNE COIN ENTRY & EXIT UPDATES !	False
Randomized Trading Bots On Uniswap Using Python | PyChain 2022	False
Remove liquidity Pancakeswap confirm not working | Stuck liquidity Pancakeswap	False
Revenant vs S8UL - Asia Champions League India 1st Stage - Pokemon Unite Tournament	False
Review of Pancakeswap Floor Can Cake Reach $100 - Crypto Investment	False
Ripple XRP Is Among The Giants Of The World! Analyst: Prepare to Go to the Moon! Cryptocurrency news last minute	False
Robbing My Best Friends Bank In Perfect Heist 2	False
RoboCast #126: BattleBots World Championship VII - Episode 1 Review [ft. Grant & James Cooper]	False
SAFEMOON KNIGHT - HUGE SAFEMOON AND PARTNERS UPDATE	False
SAFUU new crypto coin ( SAFUU ) Airdrop 500$ | REVIEW	False
SBF On Fast Track To Prison Thanks To AGGRESSIVE FTX Prosecutor!	False
SHIBA INU & Bugatti: Shibarium - make more millionaires? This Will change the crypto world	False
SHIBAINU ! Today I'm giving away $500 | crypto 2023 :smiling face with heart-eyes::rocket: go link	False
SMART BNB Flash Loan Attack Tutorial /Secret Money Making Method with BNB Network !	True
SMART BNB Flash Loan Attack Tutorial /Secret Money Making Method with BNB Network 2022	True
SMART BNB Flash Loan Attack Tutorial /Secret Money Making Method with BNB Network	True
SNIPER BOT CHAT GPT 2023 Atualizado BNB Pancakeswap Flash Loan	True
SNX A X7000 IS COMING?? - SYNTHETIX PRICE PREDICTION & LATEST NEWS	False
STAKING СAKE and EARN UP 718%  IN A YEAR:fire: The best staking strategy CAKE! staking cake latest	False
STAKING СAKE and EARN UP 718%  IN A YEAR:fire: The best staking strategy CAKE! staking cake pancakeswap	False
STEP BY STEP GUIDE TO BRIDGE FROM BSC TO POLYGON NETWORK USE BNB BUSD TO BUY MATIC IN 5 MINS 20% ROI	False
STEPN : HOW TO GET ACTIVATION CODE | STEPN REGISTRATION CODES!	False
STRONG $SUSHI NOW! | SUSHI SWAP PRICE PREDICTION & NEWS 2022!	False
SUPERCAR Build Challenge in Scrap Mechanic!	False
SURVIVING WITH JELLY In Scrap Mechanic: Survival	False
SUSHI +9624% AFTER THIS?? - SUSHISWAP PRICE PREDICTION 2023 & FORWARD	False
SUSHI MASSIVE SKYROCKET IS COMING IN 2023 - SUSHISWAP PRICE PREDICTION & ANALYSES	False
SUSHI Price Target | SUSHI Analysis | SUSHI Price Today | HUGE MOVE COMING !! | 04/11/2022	False
SUSHI SWAP $1 right now :exploding head:THE DIP #sushi #sushiswap #crypto #dogecoin #bitcoin #pancakeswap #dubai	False
SUSHI WILL GO TO THE MOON ON THIS DATE?? - SUSHISWAP PRICE PREDICTION AND LATEST UPDATES	False
SUSHI WILL REACH AN UNEXPECTED PRICE WHAT IS IT?? - SUSHISWAP PRICE PREDICTION 2023	False
SUSHISWAP (SUSHI) CRYPTOCURRENCY WILL MAKE MILLIONAIRES IN 2021 BEFORE YOU KNOW IT!!! BULLISH TEAM!!	False
SUSHISWAP Huge Coin UPDATE | SUSHI Price Prediction for 2022	False
SUSHISWAP SNIPER BOT BEST BSC DEFI AND MORE	True
SUSHISWAP SUSHI Crypto Urgent Price Breakout/Breakdown Technical Analysis - October 21	False
SUSHISWAP: PRICE UPDATE & Price Prediction!!!	False
SWING DAO TOKEN UP 300% POST LAUNCH LIVE STREAM FOR BTFA ~ ALMOST 60% OF NFTs SOLD	False
SafePal Bridge Tutorial - How to Swap Coin & Token across different networks via the SafePal Wallet	False
Sam Bankman-Fried Free on $250 Million Bail	False
Satoshi Arbitrage Bot	False
Season 13 High Elo Darius Gameplay -  How to Climb with Darius Only | How to Carry as Darius	False
Secret Method To Supercharge Your PancakeSwap USD Yield Farming & Staking Returns | Leverage + Hedge	False
Seed phrase trustwallet | Hack trustwallet #trustwallet #crypto #cryptocurrency #freemoney #usdt	False
Selling Coins in the ETH POW Network with Uniswap | Using Metamask ETHW	False
Seven $1M+ Business Ideas To Start in 2023 (#404)	False
Shiba Inu Here's Everything You Missed	False
Should I Buy XRP Now In 2023? - Stop Waiting! :rocket::rocket::rocket:	False
Should You Buy Or Sell Uniswap? | Uniswap UNI Price Prediction | Long Term Winner	False
Should you invest in TWT and How To Get The $500 Airdrop Strategy (EASY)	False
Simone Puorto Presents: Marketing for Generation Alpha: how to position your brand in the Metaverse	False
Simple straight forward way to win Everytime on the pancakeswap lottery make tons tons of BNB + cake	False
Sniper Trading Bot :face screaming in fear:  Work with metamask wallet :face screaming in fear: min 0.3bnb	True
SniperBot BSC(BNB) = PancakeSwap - PantherSwap - BakerySwap - BiSwap	True
SniperBot Universal // PancakeSwap (BSC) / UniSwap (ETH) Token Bot	True
Sniperbot Bsc(Bnb) = Pancakeswap - Pantherswap - Bakeryswap - Biswap	False
Spot Crypto arbitrage $100/DAY || how to find crypto arbitrage opportunities in 2023 || bitcoin BOT	True
Stacks (STX)   Price Analysis - Stacks (STX) NEWS - Stacks Price Chart (STX/USD)	False
Stake CAKE coin with 718% APY:glowing star:The largest percentage of CAKE coin staking | pancakeswap cake farming	False
Stake CAKE coin with 718% APY:glowing star:The largest percentage of CAKE coin staking | pancakeswap staking cake	False
Stake HEX on Pancakeswap - 820% APR :fire: hex coin staking strategy	False
Stake IMMUTABLE X  coin with 718% APY:glowing star:Largest percentage of IMMUTABLE X staking | staking imx token	False
Stake IMMUTABLE X coin with 718% APY:glowing star:The largest percentage of IMX coin staking| imx staking live	False
Stake SPELL Crypto :rocket: This is the most profitable STAKING ever :rocket:	False
Stake Shiba INU on Pancakeswap - 820% APR :fire: shib staking	False
Stake TWT coin with 718% APY:glowing star:The largest percentage of TWT coin staking | farm twt pancakeswap	False
Stake TWT coin with 718% APY:glowing star:The largest percentage of TWT coin staking | farm twt pancakeswap	False
Staking CAKE is the most profitable STAKING ever :rocket: PancakeSwap coin	False
Step By Step How to on Uniswap 50x ETH It Works Every time with ETH Flash Loan Arbitrage Tutorial	True
Step by Step Guide to Earn 30 BNB on PancakeSwap BNB Flash Loan Arbitrage Tutorial - Passive Profits	True
Steps Guide on How to Perform a Flash Loan on BSC! Earn 10 BNB Fast! No Coding Required! 2022	True
Steps Guide on How to Perform a Flash Loan on BSC! Earn 10 BNB Fast! No Coding Required!.	True
Stop buying ETH !! Make 10000x in minutes by learning to flashloan uniswap and sushiswap easy	True
Stuck on confirm this transaction on wallet Pancakeswap!! FIX	False
Sushi Coin price prediction | shushiswap coin price prediction | sushi Coin prediction	False
Sushi Price Prediction! Sushiswap News Today	False
Sushi Sushiswap Coin Update	False
Sushi Sushiswap Price News Today - Elliott Wave Technical Analysis and Price Prediction!	False
Sushi Swap Coin Future Price Prediction 2022 - SushiSwap Honest Analysis | EarnCryptoyt	False
Sushi Swap Coin is the back-bone of Defi Projects | Sushi Swap | Crypto Line	False
Sushi Swap Review in 2022: Swap Across the Bridge with Wallet Connect	False
Sushi analysis pick your entry - #sushi #sushiswap #altcointrading #shorts	False
Sushi coin Holders Must Watch! Sushiswap Price Prediction! Sushi News Today	False
SushiSwap & SUSHI... A Deep Dive Review in 2021!	False
SushiSwap (SUSHI) Bear Market Accumulation. SUSHI Chart Analysis And Price Prediction 2023	False
SushiSwap (SUSHI) Crypto Price Prediction | PUMPING NOW! Next Crypto to Explode? :rocket:	False
SushiSwap (SUSHI) Fails to Bounce From 2021 Lows- Biggest Weekly Losers	False
SushiSwap (SUSHI) Relief Rally. How High Can We Go? SUSHI Chart Analysis And Price Prediction 2023	False
SushiSwap Analysis | $SUSHI Price Could 2X :chart increasing:	False
SushiSwap Exchange Suffers Major $3.3 Million Smart Contract Hack – Here's What Happened	False
SushiSwap Exit Scam Tanks DeFi Market	False
SushiSwap Exit scams for 13 Million Dollars	False
SushiSwap Hacked #cryptobaba #crypto #cryptocurrency #eth #ethereum	False
SushiSwap Next Resistance | Sushi Price Prediction Technical Analysis Hindi Today	False
SushiSwap Price Predictions: Jim Talbot and DonAlt Bullish on Sushi/BTC	False
SushiSwap The Uniswap Killer?	False
SushiSwap Tutorial	False
SushiSwap analysis and today cost | buy sushi crypto coin	False
SushiSwap review on DEX platform 2023 | SUSHI token review | Decentralized platform #SUSHI	False
SushiSwap's Real Agenda!?  Destroy Ethereum DeFi...	False
SushiSwap’s New CEO Crypto Scam And Animal Sexual | 11 Oct 2022 | Flash News Daily #shorts	False
Sushiswap - How to Buy Million Token on the Harmony Network	False
Sushiswap Metamask - create a new liquidity pool	False
Sushiswap Price Analysis - 19th October 2021	False
Sushiswap Price Analysis - 3 February 2021	False
Sushiswap Price Prediction & Analysis! Sushi coin News Today	False
Sushiswap Price Prediction - Huge Altcoin Season Rally Incoming!!!	False
Sushiswap Price Prediction - This Will 100X In 2022! | Here's Why	False
Sushiswap Price Prediction 2021	False
Sushiswap ROI calculator and yield farming explained	False
Sushiswap Tutorial - How to Buy and Sell Crypto!	False
Sushiswap bulls undergoing a rejection too many as a slide below $1.0 could be next	False
Sushiswap migration in 5 hours	False
Sushiswap price prediction - SUSHI coin should 4x easy	False
Sushiswap to launch futures trading platform #sushiswap	False
Swap tokens pancakeswap	False
Swapping in PancakeSwap with Trust Wallet [TUTORIAL]	False
Swinca Token :check mark button: How to Buy SWI crypto on SushiSwap	False
TAFA BOT Presentation | CryptoCurrency Trading Robot System | Arbitrage Bot | More Bonuses	False
THE BEST 100X ALTCOIN TO BUY IN 2023!! :police car light: ALTCOIN SEASON HAS STARTED!!	False
THE BEST OF BASICALLYIDOWRK 2022	False
THE MOST PROFITABLE BITDAO coin STAKING at 718% :rocket: bitdao coin staking	False
THE MOST PROFITABLE CHILIZ coin STAKING at 718% :rocket: chiliz farming	False
THE MOST PROFITABLE DECENTRALAND coin STAKING at 718% :rocket: decentraland staking	False
THE MOST PROFITABLE DECENTRALAND coin STAKING at 718% :rocket:where to stake manastake mana binance	False
THE MOST PROFITABLE DERACE coin STAKING at 718% :rocket: stake derc tokens	False
THE MOST PROFITABLE DOGECHAIN coin STAKING at 718% :rocket: pancakeswap dogechain farming	False
THE MOST PROFITABLE ECOMI coin STAKING at 718% :rocket:ecomi staking	False
THE MOST PROFITABLE EVERDOME coin STAKING at 718% :rocket: everdome crypto staking	False
THE MOST PROFITABLE GALA coin STAKING at 718% :rocket: farm gala	False
THE MOST PROFITABLE ILLUVIUM coin STAKING at 718% :rocket: ilv staking	False
THE MOST PROFITABLE ILLUVIUM coin STAKING at 718% :rocket:illuvium staking	False
THE MOST PROFITABLE ONYXCOIN STAKING at 718% :rocket: staking xcn pancakeswap	False
THE MOST PROFITABLE OPENDAO coin STAKING at 718% :rocket: sos stake	False
THE MOST PROFITABLE POLKADOT coin STAKING at 718% :rocket:stake polkadot	False
THE MOST PROFITABLE POSITION EXCHANGE coin STAKING at 718% :rocket:position token staking	False
THE MOST PROFITABLE QREDO coin STAKING at 718% :rocket:stake qrdo	False
THE MOST PROFITABLE TAMADOGE coin STAKING at 718% :rocket: stake tamadoge	False
THE MOST PROFITABLE TELCOIN coin STAKING at 718% :rocket: telcoin staking v3	False
THE MOST PROFITABLE TWT coin STAKING at 718% :rocket:trust wallet stake twt coin	False
THE MOST PROFITABLE UNISWAP coin STAKING at 718% :rocket: staking uni	False
THE MOST PROFITABLE UNISWAP coin STAKING at 718% :rocket: uni stake	False
THE MOST PROFITABLE UNISWAP coin STAKING at 718% :rocket: uni token staking	False
THE MOST PROFITABLE UNISWAP coin STAKING at 718% :rocket: uni token staking	False
THE MOST PROFITABLE UNISWAP coin STAKING at 718% :rocket: uniswap coin staking	False
THE MOST PROFITABLE UNISWAP coin STAKING at 718% :rocket:staking uni pool	False
THE MOST PROFITABLE USDC coin STAKING at 718% :rocket: usdc staking cryptocom	False
THE MOST PROFITABLE USDC coin STAKING at 718% :rocket:stake usdc	False
THE MOST PROFITABLE VERASITY coin STAKING at 718% :rocket: vra token staking	False
THE MOST PROFITABLE VULCAN FORGED PYR coin STAKING at 718% :rocket: how to stake pyr	False
THE staking is the PERFECT way to make PROFIT:rocket: How to stake THE	False
THESE BENEFITS OF SHIBARIUM WILL MAKE YOU WANT TO BUY MORE BONE TOKEN!!!	False
THESHY VS OMG GOES ALL THE WAY - CAEDREL	False
THIS *NEW* CRYPTO IS EXPLOSIVE! :fire: NEXT 100X ALTCOIN GEM? :gem stone::eyes: NEXT PANCAKESWAP? :pancakes: NEW CRYPTO TODAY !	False
THIS CODE CAN MAKE MILLIONS @ UNISWAP @ SUSHISWAP FLASH LOAN ARBITRAGE.	True
THIS CODE CAN MAKE MILLIONS @ UNISWAP @ SUSHISWAP FLASH LOAN ARBITRAGE.	True
THIS CODE CAN MAKE MILLIONS @UNISWAP @SUSHISWAP FLASH LOANS ARBITRAGE.	True
THIS LEE SIN PLAY WAS ABSOLUTELY CRAZY! | ONLY Lee Sin to Masters ep. 6	False
THIS MIGHT BE ONE OF THE CHEAPEST PRICES OF BONE TOKEN EVER BEFORE SHIBARIUM TAKES IT TO $100!!!!	False
THORChain Most Exciting Since Bitcoin - Erik Voorhees #shorts	False
TIME WONDERLAND UPDATE - WHATS NEXT? ($TIME $WMEMO)	False
TIME Wonderland wMEMO Update BSGG Farming and Revenue Share	False
TIME staking is the PERFECT way to make PROFIT:rocket: How to stake TIME	False
TODAY! AIRDROP 500$ | FREE TO SUBSCRIBERS | TWT CRYPTO :fire::rocket:	False
TRADING - 2 EXEMPLES DE FRONT RUNNING	False
TRUSTWALLET AirDrop! | Claim $500 in TWT | Passive income in crypto!	False
TRUSTWALLET New Private Crypto AirDrop Event | FREE GET 500$ Without Deposit | 2022 Only	False
TRUSTWALLET token | BEST CRYPTO PROJECT for investment | CLAIM 500$ in AIRDROP	False
TRX Latest Website || Register to Get 9000TRX || Household Income || Investors	False
TSUKA staking is TSUKA PERFECT way to make PROFIT:rocket: How to stake TSUKA	False
TWO 10X ALTCOINS READY TO EXPLODE	False
TWT LIMITED NEW BEST CRYPTO AIRDROP FOR NEW USERS | CLAIM 500$ | FREE WITHOUT DEPOSIT | 2022	False
TWT Token The New Price Prediction AIRDROP 500$ TrustWallet Big Money Token	False
TWT airdrop 500$ | crypto claim token 500$ :check mark button::wrapped gift:HO-HO:Santa Claus::Christmas tree:$500:rocket::full moon::money bag:	False
TWT airdrop 500$ | crypto claim token 500$ | Don't miss your chance! top tokens and $500 bonus:wrapped gift::Christmas tree::dollar banknote::money bag:	False
Tamadoge live stream - Tier 1 Exchange announcement + Token claim info	False
Tarkov - Bot-Tier Content	False
Tasting SUSHI!! SushiSwap Still Have Potential?? :sushi:	False
Telegram Bot for PancakeSwap   How to BUY TOKENS FAST   Sniper Bot	True
Testing Automatic Crypto Profit Bots	False
The 3 Best and Worst Cases For Crypto!	False
The Best Arbitrage Bot 2020	False
The Day after Hardfork: DeFiChain Grand Central Epilogue v3.2.0 :heart on fire:	False
The DeFiChain starts with a hard fork into the year 2023.	False
The FTX collapse gets EVEN CRAZIER! | Cardano announces HUGE new developments	False
The Hybrid Range order explained on Uniswap - better than range orders!	False
The INSPIRING Backstory Behind This Terrifying Moment! (What Happened To Damar Hamlin?)	False
The Inside Story of Effie & Why She's in Danger Explained | Power Book II: Ghost Season 3	False
The Only Shopify Dropshipping Course You Will Ever Need (FREE FOR EVERYONE)	False
The Rise of Decentralized Exchanges (DEXs) #dydx #gmx #uniswap #sushiswap	True
The Secret to Free Crypto Airdrop! How To Find and Get New Cryptocurrency Retrodrops?	False
The bear market also wants to do everything possible to make money! Uniswap V3 helps you profit from bottom hunting in the bear market!	False
The insane $1.2 billion dollar crypto story - sushiswap	False
This Bot Makes You Win 70% on PancakeSwap Predictions!	False
This Is How To Make 10 BNB+ With a Sniper Bot - Easy Tutorial ( NO DOWNLOAD )	True
This New Season 13 JAX REWORK On-Hit Build Guide is BEYOND BROKEN :fire: LoL Meta Top Jax s13 Gameplay	False
This Pionex Grid Bot has 167% APR #shorts	False
This bot generates 1000$ /Day !!!	True
This champion just became the highest win-rate mage... (but who?!)	False
This code can make millions! | Uniswap & Sushiswap Flashloan Arbitrage |PANCAKE BUNNY HACKED AGAIN!!	True
This is Why Uniswap Bot code for flash Loan Arbitrage Using ETH / 2023 Updated is Going Viral	True
This is the most profitable ACH coin STAKING ever :rocket: stake ACH crypto	False
This is the most profitable AUDIUS coin STAKING ever :rocket: AUDIUS coin stake	False
This is the most profitable AXS coin STAKING ever :rocket: AXS price prediction	False
This is the most profitable BAND coin STAKING ever :rocket: BAND coin stake	False
This is the most profitable BRISE coin STAKING ever :rocket: BRISE price prediction	False
This is the most profitable DAO coin STAKING ever :rocket: DAO DAO coin Farming	False
This is the most profitable PANCAKESWAP LOTTERY EVER :rocket: pancakeswap farms and pools	False
This is the most profitable SAND coin STAKING ever :rocket: SAND coin	False
This is the most profitable STAKING EVER :rocket: stake pancakeswap usdt	False
This is the most profitable STAKING ever :rocket: Farming Pancakeswap ADA	False
This is the most profitable STAKING ever :rocket: Farming Pancakeswap AMP	False
This is the most profitable STAKING ever :rocket: Farming Pancakeswap AXS	False
This is the most profitable STAKING ever :rocket: Farming Pancakeswap BOND	False
This is the most profitable STAKING ever :rocket: Farming Pancakeswap CEEK VR	False
This is the most profitable STAKING ever :rocket: Farming Pancakeswap CVX	False
This is the most profitable STAKING ever :rocket: Farming Pancakeswap FLOW	False
This is the most profitable STAKING ever :rocket: Farming Pancakeswap IBAT	False
This is the most profitable STAKING ever :rocket: Farming Pancakeswap IMX	False
This is the most profitable STAKING ever :rocket: Farming Pancakeswap LOVELY inu	False
This is the most profitable STAKING ever :rocket: Farming Pancakeswap RSR	False
This is the most profitable STAKING ever :rocket: Farming Pancakeswap TIME	False
This is the most profitable STAKING ever :rocket: Farming Pancakeswap USDT	False
This is the most profitable STAKING ever :rocket: Farming Pancakeswap VGX	False
This is the most profitable STAKING ever :rocket: Farming Pancakeswap VLX	False
This is the most profitable STAKING ever :rocket: Farming Pancakeswap XRP	False
This is the most profitable STAKING ever :rocket: Farming Pancakeswap XYO	False
This is the most profitable STAKING ever :rocket: TIME time token Farming	False
This is the most profitable STAKING ever :rocket: dao maker stake dao	False
This is the most profitable STAKING ever :rocket: stake cake pancakeswap	False
This is the most profitable STATUS coin STAKING ever :rocket: best way to stake STATUS coin	False
This is the most profitable USDC coin STAKING ever :rocket: USDC coin stake	False
This is the most profitable WOO coin STAKING ever :rocket: best way to stake WOO coin	False
This transaction would fail pancakeswap !! SOLVED !! remove your stuck liquidity!!!!!	False
TiFi | AIRDROP 500$ | TiFi CRYPTO COIN NEW NFT 2022	False
Today Sushi coin Buy/sell New // Today All crypto Market Crash Reason Punping time / wow crypto life	False
Top 3 Staking Coins (Bear Market Passive Income :money with wings:)	False
Top 5 NEW Altcoins BIG POTENTIAL | Best Cryptocurrency Investments 2022?	False
Top 9 Crypto Coins That Could 10X in 2 Weeks (High Growth)	False
Tory Lanez Breaks Silence On Being Found Guilty Against Megan Thee Stallion	False
Trade Arbitrage 2023|Binance VS CREDITCOIN 2022| Strategy crypto	False
Trade CRYPTO PROFITABLY with TRIANGULAR ARBITRAGE [MAKE $105/DAY]	False
Trade CRYPTO PROFITABLY with TRIANGULAR ARBITRAGE [MAKE $500DAY]	False
TraderJoe  Sniper BOT // Trader Joe Swap BOT - AVAX	False
Trading bot / Front running Bot Tutorial for Pancakeswap Updated 2022	True
Trading report | Forex bot mt4 | arbitrage bot |arbitrage trading	False
Transfer from failed pancakeswap - Unable to Sell shitcoin #shorts	False
Transformers: Rescue Bots :red circle: FULL Episodes LIVE 24/7 | Transformers TV	False
Transformers: Rescue Bots | Rescue in the Rubble | FULL Episode | Kids Cartoon | Transformers Kids	False
Trust Wallet Earn 500 ETH Flash Loan + UniSwap & Pancakeswap (No Code) Arbitrage Tutorial	True
Trust Wallet Flash Loan + UniSwap & Pancakeswap on ETH Flash Loan Arbitrage Tutorial	True
Trusted platform to make crypto assets 2023:money-mouth face: Check payment received :OK hand:	False
Try With 0.05 ETH in 1 Minute - Uniswap ETH Flash Loan Arbitrage Trick 2022	True
Tutorial: How to setup Fantom ($FTM) on Metamask & buy $BOO	False
UAE SHOP is serious because it will last longer than others that do the same	False
UFO staking is the PERFECT way to make PROFIT:rocket: How to stake UFO	False
ULTIMATE GUESS THE EMOJI CHALLENGE OF ALL TIME!!! *HARDEST CHALLENGE OF THE YEAR!*	False
UNI ANALIZ #uniswap #unicoin #bitcoinnews #bitcoinprice #analiz #uniswapcoins	False
UNI COIN LATEST ENTRY & EXIT UPDATES ! UNI COIN CHART UPDATES ! UNI COIN PRICE PREDICTION !	False
UNI MASSIVE SKYROCKET - UNISWAP PRICE PREDICTION 2023 & UPDATES	False
UNI NEWS ARE SHOCKING?? - UNISWAP PRICE PREDICTIONS - SHOULD I BUY UNI??	False
UNI Uniswap Crypto Chart Analysis #shorts	False
UNI WILL REACH $65?? HERE'S WHY - UNISWAP PRICE PREDICTION & LATEST UPDATES	False
UNISWAP (UNI) MAY EXPLODE AND VALUE +1000% IN THE NEXT CRYPTO MARKET HYPE.	False
UNISWAP CRYPTO PRICE PREDICTION 2022 | Best DEX Still?	False
UNISWAP INVERSE HEAD AND SHOULDERS BREAKOUT!!	False
UNISWAP Liquidity Pool (Yield Farming) Guide - Tips for Making Money in Crypto	False
UNISWAP PRICE WILL X6000 AFTER THIS DATE?? - UNISWAP PRICE PREDICTION & ANALYSES	False
UNISWAP V3 - MEET THE WORLD'S LARGEST DECENTRALIZED BROKER (DEX) IN 2023	False
UNISWAP VAMPIRES? ETH congestion could make these next big opportunities	False
UNISWAP WAS HACKED! 500 ETHEREUM STOLEN! Crypto News Update	False
UPDATED 2022 Huge profits on the new Front running Sniper bot Easy to use and Beginner friendly!	True
UPDATED! How to make $1000 Every Day on UniSwap | #ethereum | WORKING SEPTEMBER 2022	True
UPDATED! I LEGALLY Made Over 100 BNB Passive Income On PancakeSwap using this MEV Bot | Jan 2023	True
UPDATED! I LEGALLY Made Over 100 ΞTH Passive Income Farming On Uniswap using this MEV Bot | Jan 2023	True
US to Enter 'Serious' Recession in 6 to 9 Months According to JPMorgan CEO	False
USING my SUBSCRIBERS BEST META LOADOUTS in WARZONE 2! (Modern Warfare 2)	False
USK Arbitrage on Kujira: Make 2% this week?	False
Ultimate Binance  Front Run Bot - Latest Defi Exploit Contract# Flashloan# Arbitrage#Binance#BNB	True
Ultimate Binance  Front Run Bot - Latest Defi Exploit Contract# Flashloan#bnb	True
Ultimate Binance  Front Run Bot - Latest Defi Exploit Contract	True
Ultimate FTM FANTOM Front Run Bot - Latest Defi Exploit Contract	True
Unbelievable!!! See how to stake and make a lot of USDT	False
UniSwap Vs  SushiSwap - Which Platform is Better	False
UniSwap coin started AirDrop | Claim $5000 in new #UNI UniSwap AirDrop	False
Uninstall NPM Uniswap Packages | Reinstallation Of Import Uniswap Package | Uniswap Defi Project	False
Uniswap   UNI	False
Uniswap $1000 / Day Liquidity Frontrunning Sandwitch and Arbitrage Bot for Passive Income	False
Uniswap (UNI) Price Prediction 2022	False
Uniswap (UNI) and Polkadot (DOT) | Ft: Thiago Castroneves	False
Uniswap (UNI) to $50 By February? | A Fundamental Opinion	False
Uniswap - Governance and Uniswap v3	False
Uniswap :right arrow: Passive Income with your Cryptocurrencies!	False
Uniswap Bot Code For Flash Loan Arbitrage Using FTM Fantom| 2022 Update	True
Uniswap Bullish  Run #crypto #currency #video #subscribe #shots 2023 #viralreels #shot	False
Uniswap DEX partners with MoonPay	False
Uniswap Demo	False
Uniswap Explained - Best Decentralized Trading Platform for Cryptocurrency Trading 2021	False
Uniswap Flash Loan Arbitrage Bot SCAM (FlashBot SCAM BEWARE)	False
Uniswap Front Running Bot 2022 - V3 - EASY TUTORIAL Huge profits ! 2022	True
Uniswap Front Running Bot 2022 - V3 - EASY TUTORIAL Huge profits ! 2022	True
Uniswap Front Running Bot 2022 - V3 - EASY TUTORIAL Huge profits !	True
Uniswap Front Running Bot 2022 – EASY TUTORIAL (Huge profits)	True
Uniswap Front Running Bot 2022 – EASY TUTORIAL (Huge profits)	True
Uniswap Front Running Bot 2022 – EASY TUTORIAL (Huge profits)	True
Uniswap Front Running Bot 2022 – EASY TUTORIAL (Huge profits)	True
Uniswap Price Prediction 2022 – When will UNI hit $100?	False
Uniswap ROI API rundown	False
Uniswap ROI calculator	False
Uniswap Snitching? | FTX Buys $121M in Bahamas Real Estate	False
Uniswap Testnet | Add | Remove Liquidity using Ropsten | WETH and Token Pair [Hindi]	False
Uniswap Tutorial for Beginners: How to buy and sell altcoins on the ETH network	False
Uniswap UNI 35% return #shorts #btc #bitcoin #price_prediction #shortyt #crypto #uniswap #uni #short	False
Uniswap V2 - Liquidity Delta | DeFi	False
Uniswap V3 - How to Calculate Price of ETH from sqrtPriceX96? | DeFi	False
Uniswap V3 - Single Hop Swap | DeFi	False
Uniswap V3 Concentrated Liquidity Part 1	False
Uniswap V3 Triangular Arbitrage Might Actually Work	False
Uniswap V3 | explanation and possibilities	False
Uniswap and Sushiswap arbitrage bot	False
Uniswap decentralized exchange. Uniswap Review.	False
Uniswap flash loan attack | Automated Bot	True
Uniswap in DANGER :collision: -12% CRASH Imminent? | UNI Price Prediction	False
Uniswap in vein - Mining defi's APY and APR - EP 11	False
Uniswap on Gnosis Chain	False
Uniswap v3 Announced (Think Uniswap Will Hit $50-$100)?	False
Uniswap v3 Farm - Creating Farm Matic Usdt and CRV with Matic - Pools of the week and monthly contribution	False
Uniswap v3 Has Partners!? Who!? These (2) ALTCOINs!?	False
Uniswap v3 NFTS deep dive - Liquidity providing with NFTS ?!	False
Uniswap's latest product update---Permit2 & Universal Router comprehensive introduction [Vic TALK Issue 359]	False
Unlimited Crypto Arbitrage| Binance + Ixoud exchanges 9% per Trade	False
Unsupported Chain ID Error Pancakeswap :check mark button: EASY FIX	False
Updated Binance Front Run Bot | Easy Profits in Minutes!# Flashloan #Arbitrage#Crypto#Binance#BNB	True
Updated! - How to make $1000/DAY on UniSwap? #ethereum	True
Updated! - How to make $1500/DAY on UniSwap? #eth #ethereum #crypto	True
Use Ethereum FOR FREE NO GAS FEES - Uniswap Optimism Layer 2 Guide	False
Using a 0.1KD BOT account to spectate solos BOT LOBBIES on Al Mazrah	False
Using crypto arbitrage bot to monitor crypto whales to make $643 daily	True
Using crypto arbitrage bot to monitor crypto whales to make $643 daily	False
VERDURE COIN - ARBITRAGE BOT TRADING!? - NEXT DAVOR??	False
VIDT staking is the PERFECT way to make PROFIT:rocket: How to stake VIDT	False
VIEGO MID :cheese wedge:CHEESE IS TOO GOOD! (HYPER 1v5 POTENTIAL:OK hand:) How to Viego Season 13 League of Legends	False
WHAT HAPPENED TO MY MONEY IN PANCAKESWAP???	False
WHAT IS A PANCAKESWAP ? EARN WITH TRUSTPAD !! GET $500 NOW !!!!	False
WHAT IS THE VAMPIRE ATTACK? THE CRAZY STORY OF DeFi: THE ARRIVAL OF SUSHISWAP.	False
WHO Is The MASTERMIND Who Destroyed The Crypto Markets?...	False
WHY I CHOSE COSMOS TO DCA W/ CRYPTOCITO & JERRY HALL	False
WILL GOVERNMENT BAN CRYPTO IN 2023 ? NO CRYPTO REGULATION ? NEW YEAR SPECIAL WITH KASHIF EPISODE - 2	False
WITHDRAW YOUR CRYPTO!! Cardano ADA Lashes Out On....	False
WONDERLAND $TIME URGENT UPDATE: Wrap MEMO Quick!	False
WTF IS BITCOIN and QUANT DOING!!?? NEXT TARGETS REVEALED!	False
Welcome To 2023! | Ep. 1638	False
Whale Hunt - Sam Bankman Fried (SBF) & Julien Bouteloup	False
What Altcoins Are Whales Buying? LCX Crypto News!	False
What Are Syrup Pools In Pancakeswap? (Whiteboard Animated)	False
What Can You Do With Sushi Swap?	False
What Happened to Uniswap Bot code for flash Loan Arbitrage Using ETH / 2023 Updated?	True
What Is Bitcoin || BitCoin Mining Process Explained || Telugu ||	False
What Is Uniswap? $1000 at This Price Could Turn into This...(Animated Explanation)	False
What You Thought #109 | The Moobs Like Jagger Episode	False
What is #UNISWAP #crypto #shorts #cryptocurrency	False
What is Active Concentrated Liquidity Management for Uniswap V3?	False
What is Arbitrage Bot?	False
What is Arbitrage Bot?	False
What is Arbitrage? Arbitrage Bots. Supply and demand impact on arbitrage.	False
What is Crypto Arbitrage ? Crypto Arbitrage Trading Bot Explained in HINDI | Crypto Saaga | हिंदी	False
What is Crypto Arbitrage? Is Trading Profitable with Bots?	False
What is Pancake Swap? | Cake token & Pancake Swap explained	False
What is PancakeSwap ? | PancakeSwap Guide 2022 in Hindi |CAKE Future Potential | Crypto Saaga |हिंदी	False
What is SushiSwap (SUSHI)? What You Need to Know About SushiSwap (SUSHI)	False
What is SushiSwap (SUSHI)? | SushiSwap Crypto Explained in Under 60 Seconds	False
What is UniSwap Trading Bot?	False
What is Uniswap Bot code for flash Loan Arbitrage Using ETH / 2023 Updated All About?	True
What is Yield Farming? Make Money with Yield Farming | Get Started on PancakeSwap Demo	False
What is a Liquidity Pool in Crypto? (Animated)	False
What is a Salmonella Attack (Frontrunning/Sandwich Attack Exploit)	False
What is a Vampire Attack in Crypto? (SushiSwap Stole Uniswap's Money?)	False
What is a defi arbitrage? | Build a profitable flashloan arbitrage bot	False
What’s A DEX- EXPLAINED QUICKLY For Crypto Traders!:mobile phone with arrow: #SHORTS	False
When his parents and your son saw you both in an awkward position in the kitchen| Jungkookff oneshot	False
Where Will Bitcoin Price Head This Weekend? #btc #altcoins #crypto	False
Who Killed The Crypto Billionaires?	False
Who's Going to Be The Next MLB Player to Hit 700 Home Runs?	False
Why I’m Betting On SushiSwap! #shorts 	False
Why Layer2s are CRUCIAL for Mass Adoption: What are Ethereum Layer 2 Solutions	False
Why Sushiswap crypto Is Still Important || Next 50X indicator || Cryptos Genie	False
Why Tesla Stock Collapsed | Trillionaire Mindset - Episode 67	False
Why Uniswap and Automated Market Makers Rule DeFi Trading	False
Will Jack Levin Create a Layer 1 Blockchain? Xenchain ?!	False
Will PANCAKESWAP CAKE token PUMP SOON | AUTO staking strategy | GET 500$ BONUS	False
Will PancakeSwap CAKE Token Bounce Soon ???	False
Will SushiSwap (SUSHI) Hit $250 | SushiSwap Price Analysis + Price Prediction 2021 - 2025 Explained	False
Will This Be The Next PANCAKESWAP? Passive Income Backed by REVENUE- Liquidity Pools & Yield Farming	False
Win PancakeSwap Upto $300 Every Hour | Earn Crypto Free | Free Crypto Earn | Free Cake | Free Mining	False
XEN Airdrop:gem stone: GET $XEN Based your wallet calc (the :eyes:more tx in the wallet  the Bigger the reward)	False
XYO: Data Storage and Security on a New Level  :cloud:  Crypto Dreams  :cloud:	False
YANTRA • DAY 25 | 1000X STAKING PLATFORM • PASSIVE INCOME CRYPTO :money bag: :fire:	False
YGG Announcement with Founder Beryl Li	False
YOUR DAILY CRYPTO UPDATE	False
Yankee's 'MURICA! Guns and Freedom Chat!	False
Yield Farming Explained in 60 Sec	False
Yield Farming Introduction - Crypto DEFI Beginners - Part 4	False
Yield Robot 2% Daily Arbitrage Crypto Bot	False
You can now trade OK • Okcash on SushiSwap	False
Your AVAX Flash Loan Arbitrage with 20-50 AVAX/AVALANCHE profit within 6 mins Tutorials	True
Your AVAX Flash Loan Arbitrage with 20-50 AVAX/AVALANCHE profit within 6 mins Tutorials	True
Your AVAX Flash Loan Arbitrage with 20-50 AVAX/AVALANCHE profit within 6 mins Tutorials	True
Zilliqa Price Prediction - Volatility Warning!!! Prepare For Another Price Crash!!!	False
Zoracles Token :check mark button: How to Buy ZORA crypto on SushiSwap	False
[Binance Bot] :wrapped gift:Free Download!:wrapped gift: Working 2022 :fleur-de-lis:Tested:fleur-de-lis:	True
[FREE] How to Make $1000/Day Passive Income on Uniswap | Full Guide 2022 | Bot Code For Arbitrage	True
[LIVE] Bitcoin Price & Market Update - NFT GIVEAWAY STREAM! (LIVE Analysis)	False
[P2P]CRYPTO ARBITRAGE | NEW STRATEGY BTC ARBITRAGE | PROFIT 7.5% | Binance - Ixoud	False
[SMii7Y VOD] The BEST New Prop Hunt Game	False
[SMii7Y VOD] Warzone Moments that are getting out of hand	False
[Stream] Open source TypeScript Development with Neovim	False
[Uniswap V3 Tutorial] How to participate PUNDIX-ETH Liquidity Mining Farm	False
apex legends but with a bot	False
best arbitrage trading bot	False
bnb flash loan arbitrage pancakeswap	True
crypto meme uniswap shorts	False
crypto rhymes with lambo  | chart hub technical analysis | Stream 104	False
cryptocurrency arbitrage between exchanges/ 7% in 20 minutes / binance - ixoud	False
free Bitcoin miner free BTC cloud mining Bitcoin cloud mining  mine 0 5 btc daily btc cloud mining	False
free airdrop   free $100 uniswap token   no fee   instant withdrawal #1	False
gift from Tyson Fury:wrapped gift:HO-HO:Santa Claus:CRYPTO AIRDROP BEST 2022 | CLAIM 500$ CAKE TOKEN	False
high yield ETHEREUM Arbitrage bot with a stop loss that makes tremendous amount of gain in volatilit	True
high yield ETHEREUM Arbitrage bot with a stop loss that makes tremendous amount of gain in volatilit	True
how to  buy any crypto on pancake swap and trust wallet || how to add money in trust wallet	False
how to sell your Safespace Safemoon coins on pancakeswap easily	False
instructions to create bot Frontrunning 4BNB to 34bnb (Creation guide frontrunning ) without downloading	True
it's still work!! How to flashloan uniswap and make tons of ETH easy step by step stack up now	True
laeebinu nft website || play to earn nft || token buy and sell pancakeswap||	False
make $227 per trade with Dex crypto Arbitrage pancakeswap	False
new unlimited crypto arbitrage on binance | latest arbitrage	False
pancake swap Training: How to make over $1000 with a $5 investment	False
pancakeswap ko Metamask se kaise link kare / pancakeswap per bfic kaise buy/sell kare /	False
staking cake on pancakeswap 2 TIMES BETTER	False
talking to boibot...	False
trading best crypto strategies for instant earning #13 #shorts #crypto  #short	False
twt CRYPTO AIRDROP 2023 | TRUST WALLET FREE CLAIM 500$ | NFT :money bag::money bag::money bag:	False
updated how to flash loan arbitrage uniswap and make tons of ETH easy step by step no coding needed	True
updated: how to flash loan arbitrage uniswap and make tons of ETH easy step by step no coding needed	True
|| Pacific Wallet || How to Create account and start Earning new and amazing Crypto wallet project	False
𝗚𝗲𝘁 𝗙𝗿𝗲𝗲 𝗕𝗶𝗻𝗮𝗻𝗰𝗲 𝗖𝗼𝗶𝗻 𝘂𝘀𝗶𝗻𝗴 𝗕𝗡𝗕 𝗙𝗹𝗮𝘀𝗵 𝗹𝗼𝗮𝗻 𝗔𝗿𝗯𝗶𝘁𝗿𝗮𝗴𝗲 𝗕𝗼𝘁 - 𝗨𝗽𝗱𝗮𝘁𝗲 𝗰𝗼𝗱𝗲	True
1 ETH to 1.36 ETH in just 1 Minutes	True
1-Minute Trick Save Money On Uniswap Transactions - WETH vs ETH	False
1inch DEX Aggregator Tutorial: Exchange Crypto at the Best Price	False
1poolfinance | earn dollars & tokens|A multi-chain money market protocol	False
2 Year Old Makes Pancakes #shorts	False
03/01/2023 Crypto news today Telugu | Shiba Inu coin Telugu news| luna Crypto news |Cryptocurrency	False
03/01/2023 Crypto news today |Shiba inu coin news today | Cryptocurrency | luna crypto news |Bengali	False
